Team,Rk,Player,G,MP,FG,FGA,FG%,2P,2PA,2P%,3P,3PA,3P%,FT,FTA,FT%,ORB,DRB,TRB,AST,STL,BLK,TOV,PF,PTS
North Carolina,1,Justin Jackson,40,1281,264,596,0.443,159,312,0.51,105,284,0.37,98,131,0.748,58,128,186,113,31,9,69,55,731
North Carolina,2,Joel Berry,38,1155,182,425,0.428,94,196,0.48,88,229,0.384,106,137,0.774,16,102,118,138,53,5,71,84,558
North Carolina,3,Kennedy Meeks,40,973,206,372,0.554,206,371,0.555,0,1,0,89,143,0.622,152,226,378,41,38,47,48,94,501
North Carolina,4,Isaiah Hicks,39,907,174,303,0.574,174,303,0.574,0,0,,113,145,0.779,72,141,213,55,16,29,64,119,461
North Carolina,5,Tony Bradley,38,553,102,178,0.573,102,178,0.573,0,0,,65,105,0.619,98,97,195,23,10,22,25,69,269
North Carolina,6,Luke Maye,35,495,78,163,0.479,62,123,0.504,16,40,0.4,22,38,0.579,58,80,138,41,15,7,30,63,194
North Carolina,7,Nate Britt,40,759,64,181,0.354,38,103,0.369,26,78,0.333,27,37,0.73,11,62,73,94,41,2,37,71,181
North Carolina,8,Kenny Williams,26,617,58,139,0.417,31,59,0.525,27,80,0.338,19,30,0.633,34,52,86,56,23,8,30,40,162
North Carolina,9,Theo Pinson,21,500,43,113,0.381,34,75,0.453,9,38,0.237,33,47,0.702,28,69,97,77,18,4,31,37,128
North Carolina,10,Brandon Robinson,36,281,22,64,0.344,15,34,0.441,7,30,0.233,19,29,0.655,11,32,43,28,10,3,14,31,70
North Carolina,11,Seventh Woods,40,309,17,60,0.283,15,49,0.306,2,11,0.182,25,41,0.61,6,49,55,49,21,2,42,28,61
North Carolina,12,Stilman White,27,98,10,20,0.5,8,16,0.5,2,4,0.5,16,18,0.889,5,6,11,5,3,0,3,9,38
North Carolina,13,Shea Rush,20,34,4,14,0.286,3,11,0.273,1,3,0.333,5,10,0.5,1,3,4,0,2,1,2,4,14
North Carolina,14,Kanler Coker,21,29,2,4,0.5,2,4,0.5,0,0,,5,5,1,2,2,4,1,1,0,1,6,9
North Carolina,15,Aaron Rohlman,20,34,0,1,0,0,1,0,0,0,,0,0,,1,12,13,1,1,0,1,1,0
Florida State,1,Dwayne Bacon,35,1008,221,489,0.452,164,318,0.516,57,171,0.333,104,138,0.754,35,112,147,61,35,4,71,55,603
Florida State,2,Jonathan Isaac,32,839,130,256,0.508,99,167,0.593,31,89,0.348,92,118,0.78,56,195,251,37,37,49,48,70,383
Florida State,3,Xavier Rathan-Mayes,35,969,134,296,0.453,94,172,0.547,40,124,0.323,62,117,0.53,22,90,112,168,33,4,65,70,370
Florida State,4,Terance Mann,35,876,114,198,0.576,107,175,0.611,7,23,0.304,59,89,0.663,65,94,159,58,35,6,42,82,294
Florida State,5,Michael Ojo,35,426,57,101,0.564,57,101,0.564,0,0,,58,72,0.806,55,57,112,7,10,30,27,71,172
Florida State,6,Trent Forrest,35,538,61,129,0.473,60,121,0.496,1,8,0.125,48,71,0.676,31,63,94,55,43,5,35,40,171
Florida State,7,CJ Walker,33,414,54,136,0.397,37,80,0.463,17,56,0.304,36,55,0.655,13,33,46,44,20,2,25,55,161
Florida State,8,Braian Angola-Rodas,34,402,52,115,0.452,31,65,0.477,21,50,0.42,32,41,0.78,11,44,55,42,15,4,18,40,157
Florida State,9,PJ Savoy,28,227,47,114,0.412,7,14,0.5,40,100,0.4,21,30,0.7,4,19,23,7,10,1,9,15,155
Florida State,10,Jarquez Smith,35,460,60,115,0.522,57,105,0.543,3,10,0.3,30,46,0.652,34,65,99,17,8,30,25,84,153
Florida State,11,Chris Koumadje,35,355,53,81,0.654,53,80,0.663,0,1,0,12,25,0.48,19,46,65,4,7,40,17,60,118
Florida State,12,Phil Cofer,32,399,38,84,0.452,32,68,0.471,6,16,0.375,12,20,0.6,21,41,62,7,4,3,25,32,94
Florida State,13,Brandon Allen,14,87,15,32,0.469,5,9,0.556,10,23,0.435,2,2,1,1,5,6,4,2,2,3,10,42
Louisville,1,Donovan Mitchell,34,1098,181,444,0.408,101,218,0.463,80,226,0.354,87,108,0.806,37,128,165,93,70,17,56,88,529
Louisville,2,Deng Adel,33,993,141,333,0.423,97,207,0.469,44,126,0.349,74,96,0.771,23,124,147,70,20,12,45,61,400
Louisville,3,Quentin Snider,28,877,116,301,0.385,60,151,0.397,56,150,0.373,59,82,0.72,22,53,75,115,17,0,42,43,347
Louisville,4,Jaylen Johnson,34,696,106,180,0.589,102,173,0.59,4,7,0.571,55,88,0.625,91,105,196,18,16,17,44,82,271
Louisville,5,Mangok Mathiang,33,686,104,196,0.531,104,196,0.531,0,0,,51,76,0.671,85,113,198,24,17,37,38,82,259
Louisville,6,Raymond Spalding,34,653,79,134,0.59,79,131,0.603,0,3,0,42,77,0.545,65,123,188,27,22,29,43,88,200
Louisville,7,V.J. King,33,444,60,139,0.432,44,101,0.436,16,38,0.421,46,56,0.821,17,51,68,16,7,3,22,25,182
Louisville,8,Anas Mahmoud,31,580,76,122,0.623,76,122,0.623,0,0,,24,52,0.462,47,77,124,26,27,65,35,82,176
Louisville,9,Tony Hicks,23,231,32,81,0.395,27,61,0.443,5,20,0.25,17,27,0.63,2,22,24,19,10,1,21,16,86
Louisville,10,Ryan McMahon,28,176,20,60,0.333,1,8,0.125,19,52,0.365,12,14,0.857,2,12,14,17,6,2,10,30,71
Louisville,11,David Levitch,32,296,20,54,0.37,7,20,0.35,13,34,0.382,6,13,0.462,11,27,38,29,10,0,7,32,59
Louisville,12,Matz Stockman,18,74,11,17,0.647,11,17,0.647,0,0,,9,15,0.6,12,9,21,3,2,3,7,16,31
Louisville,13,Jay Henderson,17,35,5,16,0.313,4,8,0.5,1,8,0.125,4,4,1,0,3,3,3,3,0,1,6,15
Louisville,14,Tyler Sharpe,7,11,1,8,0.125,1,2,0.5,0,6,0,0,0,,1,2,3,1,0,0,1,1,2
Notre Dame,1,Bonzie Colson,36,1156,236,449,0.526,210,389,0.54,26,60,0.433,141,180,0.783,104,258,362,56,40,50,44,81,639
Notre Dame,2,V.J. Beachem,36,1230,187,443,0.422,100,202,0.495,87,241,0.361,61,73,0.836,23,123,146,31,33,38,40,46,522
Notre Dame,3,Matt Farrell,36,1238,172,384,0.448,91,191,0.476,81,193,0.42,81,102,0.794,9,63,72,196,51,5,91,71,506
Notre Dame,4,Steve Vasturia,36,1244,162,374,0.433,104,212,0.491,58,162,0.358,91,100,0.91,25,116,141,119,43,4,58,75,473
Notre Dame,5,Temple Gibbs,36,539,51,136,0.375,34,83,0.41,17,53,0.321,49,59,0.831,12,41,53,62,26,2,28,49,168
Notre Dame,6,Rex Pflueger,35,751,59,133,0.444,32,65,0.492,27,68,0.397,19,29,0.655,18,78,96,53,31,12,24,60,164
Notre Dame,7,Matt Ryan,36,286,43,99,0.434,7,16,0.438,36,83,0.434,9,10,0.9,6,26,32,14,6,1,13,29,131
Notre Dame,8,Martinas Geben,34,421,42,65,0.646,42,65,0.646,0,0,,23,30,0.767,42,73,115,25,13,11,22,66,107
Notre Dame,9,Austin Torres,36,261,21,38,0.553,21,38,0.553,0,0,,6,18,0.333,23,29,52,7,9,8,9,46,48
Notre Dame,10,John Mooney,12,46,5,8,0.625,3,4,0.75,2,4,0.5,2,2,1,6,13,19,2,1,1,1,5,14
Notre Dame,11,Elijah Burns,11,44,1,4,0.25,1,3,0.333,0,1,0,7,8,0.875,5,4,9,1,2,1,2,5,9
Notre Dame,12,Patrick Mazza,4,4,1,2,0.5,1,2,0.5,0,0,,0,0,,0,1,1,0,0,1,1,0,2
Notre Dame,13,Matt Gregory,5,6,0,4,0,0,0,,0,4,0,0,0,,0,0,0,0,0,0,0,0,0
Duke,1,Luke Kennard,37,1314,237,484,0.49,149,283,0.527,88,201,0.438,160,187,0.856,43,145,188,91,31,13,59,83,722
Duke,2,Grayson Allen,34,1007,141,356,0.396,60,134,0.448,81,222,0.365,129,159,0.811,23,104,127,119,26,2,74,78,492
Duke,3,Jayson Tatum,29,966,165,365,0.452,125,248,0.504,40,117,0.342,118,139,0.849,39,174,213,62,39,33,76,86,488
Duke,4,Frank Jackson,36,895,133,281,0.473,82,151,0.543,51,130,0.392,77,102,0.755,23,68,91,61,21,2,49,85,394
Duke,5,Amile Jefferson,35,1039,146,238,0.613,146,238,0.613,0,0,,90,143,0.629,84,209,293,53,24,65,49,93,382
Duke,6,Matt Jones,37,1216,95,239,0.397,45,93,0.484,50,146,0.342,19,26,0.731,37,67,104,72,62,6,41,86,259
Duke,7,Harry Giles,26,300,45,78,0.577,45,78,0.577,0,0,,12,24,0.5,41,59,100,9,9,17,18,58,102
Duke,8,Chase Jeter,16,238,13,26,0.5,13,26,0.5,0,0,,15,27,0.556,18,25,43,6,7,17,17,31,41
Duke,9,Marques Bolden,24,157,16,35,0.457,16,35,0.457,0,0,,5,8,0.625,14,12,26,2,2,7,11,32,37
Duke,10,Antonio Vrankovic,13,101,13,19,0.684,13,19,0.684,0,0,,7,11,0.636,16,18,34,5,0,4,7,16,33
Duke,11,Jack White,10,61,6,9,0.667,5,7,0.714,1,2,0.5,8,10,0.8,2,11,13,1,1,2,4,5,21
Duke,12,Javin DeLaurier,12,86,9,11,0.818,9,10,0.9,0,1,0,1,4,0.25,8,15,23,1,4,4,8,21,19
Duke,13,Justin Robinson,6,10,0,0,,0,0,,0,0,,1,2,0.5,0,1,1,0,0,0,0,0,1
Duke,14,Brennan Besser,1,2,0,1,0,0,0,,0,1,0,0,0,,0,0,0,0,0,0,0,1,0
Duke,15,Nick Pagliuca,5,8,0,2,0,0,0,,0,2,0,0,0,,0,0,0,2,0,0,0,0,0
Virginia,1,London Perrantes,34,1093,146,353,0.414,81,179,0.453,65,174,0.374,74,91,0.813,11,91,102,128,25,2,58,33,431
Virginia,2,Marial Shayok,34,702,121,272,0.445,102,214,0.477,19,58,0.328,43,54,0.796,12,70,82,33,30,10,36,46,304
Virginia,3,Devon Hall,34,931,100,245,0.408,68,159,0.428,32,86,0.372,52,67,0.776,22,127,149,65,18,4,35,65,284
Virginia,4,Kyle Guy,34,634,90,205,0.439,39,102,0.382,51,103,0.495,25,35,0.714,5,52,57,45,13,1,21,37,256
Virginia,5,Isaiah Wilkins,33,874,90,162,0.556,86,155,0.555,4,7,0.571,40,57,0.702,78,120,198,37,33,43,34,61,224
Virginia,6,Darius Thompson,33,686,76,171,0.444,50,97,0.515,26,74,0.351,26,43,0.605,6,48,54,73,28,12,33,33,204
Virginia,7,Ty Jerome,34,473,52,110,0.473,23,37,0.622,29,73,0.397,14,18,0.778,1,54,55,50,15,2,30,59,147
Virginia,8,Jack Salt,34,627,52,93,0.559,52,93,0.559,0,0,,22,45,0.489,53,84,137,13,11,22,21,88,126
Virginia,9,Jarred Reuter,32,344,52,89,0.584,52,89,0.584,0,0,,19,25,0.76,26,43,69,20,7,2,27,44,123
Virginia,10,Mamadi Diakite,32,449,50,92,0.543,47,81,0.58,3,11,0.273,18,33,0.545,28,54,82,6,8,39,13,75,121
Virginia,11,Austin Nichols,1,16,4,7,0.571,4,6,0.667,0,1,0,3,3,1,0,3,3,0,0,0,0,3,11
Virginia,12,Justice Bartley,10,27,4,9,0.444,3,4,0.75,1,5,0.2,0,2,0,0,7,7,1,0,1,5,5,9
Virginia,13,Trevon Gross Jr.,11,26,1,12,0.083,0,4,0,1,8,0.125,0,1,0,3,2,5,2,2,0,4,4,3
Virginia,14,Jeff Jones,5,18,1,3,0.333,0,1,0,1,2,0.5,0,0,,1,2,3,0,0,0,2,3,3
Virginia Tech,1,Zach LeDay,32,945,178,329,0.541,167,289,0.578,11,40,0.275,162,211,0.768,78,157,235,38,19,33,60,88,529
Virginia Tech,2,Seth Allen,32,925,147,272,0.54,95,155,0.613,52,117,0.444,70,96,0.729,8,66,74,106,24,5,88,61,416
Virginia Tech,3,Ahmed Hill,33,979,124,277,0.448,64,118,0.542,60,159,0.377,70,95,0.737,10,97,107,40,8,6,37,74,378
Virginia Tech,4,Justin Robinson,33,1040,99,241,0.411,61,133,0.459,38,108,0.352,103,134,0.769,16,84,100,160,23,6,81,81,339
Virginia Tech,5,Justin Bibbs,33,1032,107,262,0.408,40,105,0.381,67,157,0.427,31,41,0.756,11,82,93,54,12,3,35,71,312
Virginia Tech,6,Chris Clarke,24,694,97,165,0.588,94,152,0.618,3,13,0.231,77,114,0.675,35,140,175,79,30,7,49,48,274
Virginia Tech,7,Ty Outlaw,33,585,70,145,0.483,13,29,0.448,57,116,0.491,10,13,0.769,11,82,93,11,9,10,15,62,207
Virginia Tech,8,Khadim Sy,32,364,55,97,0.567,54,96,0.563,1,1,1,16,27,0.593,28,58,86,6,3,20,24,45,127
Virginia Tech,9,Seth LeDay,1,25,5,11,0.455,5,11,0.455,0,0,,4,4,1,4,3,7,2,0,0,1,2,14
Virginia Tech,10,Johnny Hamilton,3,21,4,4,1,4,4,1,0,0,,3,6,0.5,3,1,4,0,2,1,0,3,11
Virginia Tech,11,Matt Galloway,14,39,1,9,0.111,0,0,,1,9,0.111,0,0,,0,1,1,1,1,0,0,8,3
Virginia Tech,12,Greg Donlon,1,1,0,1,0,0,1,0,0,0,,0,0,,0,0,0,0,0,0,0,0,0
Miami (FL),1,Davon Reed,33,1165,161,372,0.433,82,173,0.474,79,199,0.397,90,108,0.833,28,130,158,80,43,16,67,52,491
Miami (FL),2,Ja'Quan Newton,30,942,150,332,0.452,139,292,0.476,11,40,0.275,93,133,0.699,18,87,105,101,34,1,98,49,404
Miami (FL),3,Bruce Brown,33,1053,134,292,0.459,101,197,0.513,33,95,0.347,90,121,0.744,48,138,186,106,49,18,67,83,391
Miami (FL),4,Kamari Murphy,33,971,95,188,0.505,95,187,0.508,0,1,0,42,69,0.609,79,162,241,18,13,23,50,78,232
Miami (FL),5,Anthony Lawrence Jr.,33,856,72,173,0.416,37,74,0.5,35,99,0.354,45,62,0.726,27,97,124,57,42,15,47,78,224
Miami (FL),6,Dejan Vasiljevic,33,575,65,182,0.357,14,36,0.389,51,146,0.349,16,20,0.8,5,39,44,15,11,1,13,31,197
Miami (FL),7,Dewan Huell,32,557,77,145,0.531,77,143,0.538,0,2,0,33,51,0.647,45,54,99,6,13,25,30,61,187
Miami (FL),8,Ebuka Izundu,32,417,54,99,0.545,54,99,0.545,0,0,,29,42,0.69,47,50,97,6,7,25,27,73,137
Miami (FL),9,Rodney Miller,14,57,5,11,0.455,5,11,0.455,0,0,,4,9,0.444,4,5,9,0,0,1,1,6,14
Miami (FL),10,Mike Robinson,9,20,0,5,0,0,1,0,0,4,0,1,2,0.5,1,0,1,0,1,0,1,2,1
Miami (FL),11,Josh Heath,6,12,0,1,0,0,0,,0,1,0,0,0,,0,2,2,0,0,0,0,0,0
Syracuse,1,Andrew White III,34,1266,199,453,0.439,87,173,0.503,112,280,0.4,118,141,0.837,28,130,158,38,55,12,56,72,628
Syracuse,2,Tyler Lydon,34,1227,151,320,0.472,102,195,0.523,49,125,0.392,97,116,0.836,79,215,294,70,35,49,59,84,448
Syracuse,3,Tyus Battle,34,1044,127,293,0.433,67,129,0.519,60,164,0.366,71,89,0.798,10,61,71,58,44,8,39,66,385
Syracuse,4,John Gillon,34,1015,105,257,0.409,51,127,0.402,54,130,0.415,93,107,0.869,13,49,62,184,49,1,72,52,357
Syracuse,5,Taurean Thompson,34,607,130,237,0.549,127,221,0.575,3,16,0.188,49,76,0.645,47,83,130,19,23,32,44,84,312
Syracuse,6,Tyler Roberson,34,692,77,136,0.566,77,136,0.566,0,0,,25,56,0.446,65,102,167,30,18,27,37,70,179
Syracuse,7,Franklin Howard,33,533,49,139,0.353,31,82,0.378,18,57,0.316,33,53,0.623,18,36,54,120,38,5,57,56,149
Syracuse,8,DaJuan Coleman,17,265,38,70,0.543,38,69,0.551,0,1,0,20,35,0.571,31,50,81,3,7,9,23,37,96
Syracuse,9,Paschal Chukwu,7,108,6,9,0.667,6,9,0.667,0,0,,0,9,0,11,18,29,2,3,14,10,15,12
Syracuse,10,Doyin Akintobi-Adeyeye,12,19,5,11,0.455,5,11,0.455,0,0,,0,1,0,4,2,6,0,1,2,3,5,10
Syracuse,11,Adrian Autry,12,17,3,9,0.333,1,2,0.5,2,7,0.286,0,1,0,0,3,3,0,2,0,0,1,8
Syracuse,12,Ky Feldman,9,14,2,6,0.333,1,1,1,1,5,0.2,0,0,,1,1,2,2,0,0,0,0,5
Syracuse,13,Ray Featherston,3,4,1,1,1,0,0,,1,1,1,0,0,,0,0,0,0,0,0,0,0,3
Syracuse,14,Shaun Belbey,12,18,1,5,0.2,1,3,0.333,0,2,0,0,0,,0,0,0,2,0,0,2,0,2
Syracuse,15,Evan Dourdas,3,3,0,0,,0,0,,0,0,,0,0,,0,0,0,0,0,0,1,0,0
Syracuse,16,Jonathan Radner,4,6,0,2,0,0,1,0,0,1,0,0,0,,0,2,2,2,0,0,1,0,0
Syracuse,17,Mike Sutton,7,12,0,2,0,0,0,,0,2,0,0,1,0,1,3,4,2,0,0,1,0,0
Wake Forest,1,John Collins,33,878,234,376,0.622,234,375,0.624,0,1,0,164,220,0.745,124,200,324,17,21,52,60,98,632
Wake Forest,2,Bryant Crawford,33,1049,169,386,0.438,115,230,0.5,54,156,0.346,142,172,0.826,11,115,126,182,49,9,76,93,534
Wake Forest,3,Keyshawn Woods,33,1007,151,305,0.495,102,193,0.528,49,112,0.438,62,82,0.756,23,116,139,116,18,0,57,87,413
Wake Forest,4,Konstantinos Mitoglou,33,811,93,221,0.421,64,134,0.478,29,87,0.333,80,100,0.8,59,143,202,29,20,22,49,76,295
Wake Forest,5,Austin Arians,33,754,94,201,0.468,33,58,0.569,61,143,0.427,33,37,0.892,16,46,62,37,17,3,21,67,282
Wake Forest,6,Mitchell Wilbekin,32,792,63,177,0.356,16,61,0.262,47,116,0.405,50,56,0.893,5,42,47,49,25,2,21,59,223
Wake Forest,7,Brandon Childress,33,710,63,177,0.356,36,100,0.36,27,77,0.351,65,84,0.774,6,65,71,71,27,1,47,54,218
Wake Forest,8,Doral Moore,31,258,32,61,0.525,32,61,0.525,0,0,,16,30,0.533,25,44,69,1,2,27,24,62,80
Wake Forest,9,Greg McClinton,26,184,14,27,0.519,13,26,0.5,1,1,1,1,5,0.2,20,13,33,1,4,1,10,34,30
Wake Forest,10,Sam Japhet-Mathias,17,69,5,10,0.5,5,10,0.5,0,0,,2,2,1,7,8,15,1,0,4,7,22,12
Wake Forest,11,Trent VanHorn,20,54,2,5,0.4,2,5,0.4,0,0,,2,2,1,1,4,5,5,0,0,3,10,6
Wake Forest,12,Donovan Mitchell,4,7,1,1,1,1,1,1,0,0,,1,2,0.5,0,1,1,0,0,0,2,0,3
Wake Forest,13,Troy Rike,5,6,1,1,1,1,1,1,0,0,,0,1,0,1,2,3,0,0,0,1,2,2
Wake Forest,14,Rich Washington,8,17,1,6,0.167,1,2,0.5,0,4,0,0,0,,0,2,2,3,0,0,1,3,2
Wake Forest,15,Aaron Spivey,2,2,0,0,,0,0,,0,0,,1,2,0.5,0,1,1,0,0,0,0,0,1
Wake Forest,16,Anthony Bilas,2,2,0,1,0,0,1,0,0,0,,0,0,,0,0,0,0,0,0,0,1,0
Georgia Tech,1,Josh Okogie,37,1141,194,428,0.453,166,355,0.468,28,73,0.384,180,241,0.747,55,146,201,61,48,27,77,94,596
Georgia Tech,2,Ben Lammers,37,1309,214,415,0.516,213,413,0.516,1,2,0.5,98,133,0.737,111,231,342,78,43,125,64,85,527
Georgia Tech,3,Tadric Jackson,36,857,169,379,0.446,129,256,0.504,40,123,0.325,59,104,0.567,13,67,80,65,24,7,60,69,437
Georgia Tech,4,Quinton Stephens,37,1232,130,347,0.375,70,157,0.446,60,190,0.316,64,93,0.688,50,233,283,80,44,27,72,80,384
Georgia Tech,5,Josh Heath,33,1014,67,169,0.396,56,126,0.444,11,43,0.256,31,44,0.705,13,73,86,144,39,6,83,68,176
Georgia Tech,6,Justin Moore,34,638,59,137,0.431,56,127,0.441,3,10,0.3,27,51,0.529,15,45,60,81,15,4,51,58,148
Georgia Tech,7,Corey Heyward,37,621,21,70,0.3,11,37,0.297,10,33,0.303,20,32,0.625,17,50,67,38,20,2,18,55,72
Georgia Tech,8,Christian Matthews,15,107,15,39,0.385,9,25,0.36,6,14,0.429,15,20,0.75,2,7,9,4,3,3,6,10,51
Georgia Tech,9,Sylvester Ogbonda,23,120,13,27,0.481,13,27,0.481,0,0,,10,16,0.625,7,17,24,4,3,6,9,28,36
Georgia Tech,10,Kellen McCormick,24,113,12,16,0.75,1,1,1,11,15,0.733,0,0,,1,7,8,3,2,0,5,6,35
Georgia Tech,11,Abdoulaye Gueye,20,201,11,28,0.393,11,25,0.44,0,3,0,1,6,0.167,18,31,49,9,3,12,24,33,23
Georgia Tech,12,Jodan Price,15,43,2,14,0.143,1,4,0.25,1,10,0.1,0,0,,0,7,7,1,1,2,0,0,5
Georgia Tech,13,Norman Harris,4,7,1,4,0.25,1,4,0.25,0,0,,0,0,,1,0,1,0,0,0,1,2,2
Georgia Tech,14,Shaheed Medlock,3,6,1,3,0.333,1,3,0.333,0,0,,0,0,,0,1,1,0,0,0,0,3,2
Georgia Tech,15,Rand Rowland,8,16,1,3,0.333,1,3,0.333,0,0,,0,0,,3,1,4,2,0,0,3,1,2
Clemson,1,Jaron Blossomgame,33,1133,219,440,0.498,195,346,0.564,24,94,0.255,119,167,0.713,59,148,207,51,27,30,56,53,581
Clemson,2,Avry Holmes,33,886,103,248,0.415,34,92,0.37,69,156,0.442,66,81,0.815,16,63,79,44,34,1,27,40,341
Clemson,3,Marcquise Reed,33,711,99,236,0.419,67,155,0.432,32,81,0.395,96,106,0.906,16,60,76,64,46,1,40,56,326
Clemson,4,Shelton Mitchell,29,783,105,229,0.459,76,165,0.461,29,64,0.453,75,94,0.798,11,57,68,103,19,2,59,48,314
Clemson,5,Donte Grantham,33,915,91,236,0.386,53,119,0.445,38,117,0.325,24,32,0.75,42,101,143,51,25,21,40,44,244
Clemson,6,Gabe DeVoe,33,792,87,228,0.382,43,94,0.457,44,134,0.328,18,30,0.6,22,71,93,62,37,7,47,51,236
Clemson,7,Sidy Djitte,32,752,72,136,0.529,71,134,0.53,1,2,0.5,64,94,0.681,116,131,247,23,23,27,49,96,209
Clemson,8,Elijah Thomas,24,405,78,135,0.578,78,134,0.582,0,1,0,23,48,0.479,31,70,101,7,17,28,20,85,179
Clemson,9,Legend Robertin,15,97,6,10,0.6,6,10,0.6,0,0,,2,12,0.167,6,8,14,0,1,13,3,17,14
Clemson,10,Ty Hudson,18,93,4,21,0.19,2,8,0.25,2,13,0.154,0,0,,1,3,4,6,2,0,7,8,10
Clemson,11,Scott Spencer,7,29,4,12,0.333,4,10,0.4,0,2,0,0,0,,0,3,3,0,1,0,0,2,8
Clemson,12,Lyles Davis,4,8,1,1,1,1,1,1,0,0,,0,2,0,0,4,4,2,2,0,0,0,2
Clemson,13,Isaac Fields,3,6,1,2,0.5,1,1,1,0,1,0,0,0,,0,0,0,0,0,0,0,0,2
Clemson,14,Riley McGillan,6,15,1,5,0.2,1,1,1,0,4,0,0,0,,0,0,0,1,1,0,1,1,2
Pittsburgh,1,Michael Young,33,1097,217,478,0.454,175,356,0.492,42,122,0.344,172,221,0.778,53,170,223,90,19,25,70,59,648
Pittsburgh,2,Jamel Artis,32,1097,196,413,0.475,122,224,0.545,74,189,0.392,116,158,0.734,40,116,156,106,13,9,83,61,582
Pittsburgh,3,Cameron Johnson,33,1099,127,283,0.449,49,96,0.51,78,187,0.417,60,74,0.811,23,126,149,77,31,11,38,86,392
Pittsburgh,4,Sheldon Jeter,33,955,94,222,0.423,66,145,0.455,28,77,0.364,52,72,0.722,79,161,240,54,30,33,50,92,268
Pittsburgh,5,Chris Jones,32,1026,76,161,0.472,64,121,0.529,12,40,0.3,65,95,0.684,20,77,97,70,18,9,53,73,229
Pittsburgh,6,Ryan Luther,21,406,42,78,0.538,33,56,0.589,9,22,0.409,27,36,0.75,25,57,82,15,5,14,33,48,120
Pittsburgh,7,Jonathan Milligan,27,227,18,63,0.286,2,13,0.154,16,50,0.32,7,8,0.875,2,6,8,15,1,1,13,20,59
Pittsburgh,8,Justice Kithcart,29,385,14,46,0.304,10,25,0.4,4,21,0.19,7,22,0.318,5,16,21,34,9,4,18,41,39
Pittsburgh,9,Rozelle Nix,20,126,9,24,0.375,9,24,0.375,0,0,,9,13,0.692,18,34,52,1,0,4,7,33,27
Pittsburgh,10,Damon Wilson,29,183,8,31,0.258,8,19,0.421,0,12,0,7,12,0.583,1,13,14,9,1,1,11,21,23
Pittsburgh,11,Corey Manigault,18,80,5,20,0.25,5,17,0.294,0,3,0,5,8,0.625,5,10,15,2,0,1,0,13,15
Pittsburgh,12,Ryan Seelye,2,4,1,1,1,1,1,1,0,0,,0,0,,0,0,0,0,0,0,0,0,2
Pittsburgh,13,Zach Smith,8,15,0,5,0,0,0,,0,5,0,0,0,,1,1,2,0,0,0,1,1,0
North Carolina State,1,Dennis Smith Jr.,32,1114,191,420,0.455,136,267,0.509,55,153,0.359,143,200,0.715,26,120,146,197,62,14,108,67,580
North Carolina State,2,Terry Henderson,32,988,136,314,0.433,58,111,0.523,78,203,0.384,90,117,0.769,22,77,99,51,22,18,51,76,440
North Carolina State,3,Abdul-Malik Abu,32,911,153,289,0.529,153,285,0.537,0,4,0,71,99,0.717,71,153,224,34,13,28,64,100,377
North Carolina State,4,Torin Dorn,32,768,114,228,0.5,90,162,0.556,24,66,0.364,53,78,0.679,29,119,148,27,13,4,43,42,305
North Carolina State,5,Maverick Rowan,25,748,106,247,0.429,53,100,0.53,53,147,0.361,34,40,0.85,21,71,92,22,16,4,30,44,299
North Carolina State,6,Omer Yurtseven,22,416,53,116,0.457,52,113,0.46,1,3,0.333,23,32,0.719,30,66,96,26,4,16,28,62,130
North Carolina State,7,Markell Johnson,30,611,46,122,0.377,34,74,0.459,12,48,0.25,15,26,0.577,15,34,49,68,26,10,32,56,119
North Carolina State,8,Ted Kapita,26,328,45,74,0.608,45,74,0.608,0,0,,23,28,0.821,29,59,88,9,2,8,25,50,113
North Carolina State,9,BeeJay Anya,27,347,28,52,0.538,28,52,0.538,0,0,,19,43,0.442,20,48,68,11,3,33,19,56,75
North Carolina State,10,Shaun Kirk,14,64,9,16,0.563,6,6,1,3,10,0.3,4,5,0.8,1,12,13,2,1,1,6,9,25
North Carolina State,11,Darius Hicks,21,132,2,8,0.25,2,7,0.286,0,1,0,4,17,0.235,9,15,24,7,0,3,7,16,8
North Carolina State,12,Chris Corchiani,5,7,2,6,0.333,2,6,0.333,0,0,,2,2,1,0,0,0,2,0,0,2,2,6
North Carolina State,13,Tucker Thompson,5,7,3,5,0.6,3,5,0.6,0,0,,0,0,,1,1,2,0,0,0,0,2,6
North Carolina State,14,Chris Brickhouse,6,9,0,1,0,0,1,0,0,0,,0,0,,3,2,5,1,0,1,2,0,0
Boston College,1,Jerome Robinson,32,1089,212,502,0.422,158,340,0.465,54,162,0.333,117,162,0.722,19,104,123,108,55,12,102,89,595
Boston College,2,Ky Bowman,32,920,160,325,0.492,98,187,0.524,62,138,0.449,74,104,0.712,25,130,155,92,37,4,93,77,456
Boston College,3,Jordan Chatman,32,794,87,208,0.418,29,69,0.42,58,139,0.417,42,46,0.913,12,57,69,34,20,7,36,54,274
Boston College,4,A.J. Turner,32,987,97,230,0.422,48,98,0.49,49,132,0.371,27,40,0.675,20,85,105,96,19,7,33,47,270
Boston College,5,Connar Tava,32,809,65,136,0.478,59,105,0.562,6,31,0.194,53,80,0.663,46,128,174,67,22,10,70,85,189
Boston College,6,Mo Jeffers,32,651,75,151,0.497,75,151,0.497,0,0,,29,53,0.547,63,117,180,16,12,17,45,89,179
Boston College,7,Nik Popovic,29,401,78,159,0.491,73,142,0.514,5,17,0.294,17,32,0.531,32,69,101,13,3,9,30,71,178
Boston College,8,Garland Owens,28,294,21,50,0.42,17,33,0.515,4,17,0.235,8,14,0.571,20,43,63,23,3,6,16,37,54
Boston College,9,Ty Graves,11,207,19,50,0.38,7,17,0.412,12,33,0.364,3,5,0.6,0,10,10,18,0,2,18,15,53
Boston College,10,Johncarlos Reyes,21,134,15,28,0.536,15,28,0.536,0,0,,4,10,0.4,5,19,24,4,4,11,7,21,34
Boston College,11,Mike Sagay,15,67,11,29,0.379,7,22,0.318,4,7,0.571,4,10,0.4,3,11,14,0,2,1,7,6,30
Boston College,12,Ervins Meznieks,9,41,3,10,0.3,1,2,0.5,2,8,0.25,0,0,,1,4,5,2,2,1,5,6,8
Boston College,13,Matt DiLuccio,1,1,0,0,,0,0,,0,0,,0,0,,0,0,0,0,0,0,0,0,0
Boston College,14,Gordon Gehan,3,3,0,2,0,0,1,0,0,1,0,0,0,,0,0,0,0,0,0,0,0,0
Boston College,15,Aser Ghebremichael,2,2,0,0,,0,0,,0,0,,0,0,,0,1,1,0,0,0,0,0,0
Kentucky,1,Malik Monk,38,1218,251,558,0.45,147,296,0.497,104,262,0.397,148,180,0.822,12,83,95,87,36,19,75,72,754
Kentucky,2,De'Aaron Fox,36,1064,214,448,0.478,197,379,0.52,17,69,0.246,156,211,0.739,20,122,142,165,53,7,87,90,601
Kentucky,3,Edrice Adebayo,38,1145,170,284,0.599,170,283,0.601,0,1,0,154,236,0.653,118,186,304,32,26,57,64,99,494
Kentucky,4,Isaiah Briscoe,36,1095,163,347,0.47,146,288,0.507,17,59,0.288,94,148,0.635,53,142,195,152,30,7,89,92,437
Kentucky,5,Derek Willis,38,833,98,205,0.478,49,75,0.653,49,130,0.377,22,32,0.688,40,165,205,33,25,39,26,76,267
Kentucky,6,Dominique Hawkins,38,731,56,139,0.403,34,75,0.453,22,64,0.344,44,53,0.83,23,39,62,64,30,0,18,78,178
Kentucky,7,Wenyen Gabriel,38,672,60,148,0.405,40,85,0.471,20,63,0.317,34,55,0.618,61,123,184,26,11,33,29,91,174
Kentucky,8,Mychal Mulder,32,338,52,128,0.406,17,32,0.531,35,96,0.365,12,13,0.923,16,32,48,12,8,6,11,27,151
Kentucky,9,Isaac Humphries,38,315,45,88,0.511,45,88,0.511,0,0,,15,25,0.6,51,55,106,9,8,18,16,58,105
Kentucky,10,Sacha Killeya-Jones,14,96,17,29,0.586,17,29,0.586,0,0,,6,15,0.4,12,19,31,2,1,10,7,19,40
Kentucky,11,Tai Wynyard,15,54,5,6,0.833,5,6,0.833,0,0,,1,3,0.333,5,8,13,1,1,3,2,11,11
Kentucky,12,Brad Calipari,15,45,2,13,0.154,0,1,0,2,12,0.167,2,5,0.4,1,2,3,1,0,1,2,3,8
Kentucky,13,Jonny David,7,11,1,2,0.5,0,1,0,1,1,1,2,4,0.5,0,0,0,0,0,0,3,0,5
Kentucky,14,Dillon Pulliam,6,8,0,1,0,0,1,0,0,0,,0,0,,0,1,1,1,0,0,1,0,0
Florida,1,KeVaughn Allen,36,1029,168,383,0.439,90,172,0.523,78,211,0.37,91,103,0.883,8,78,86,53,46,10,46,58,505
Florida,2,Devin Robinson,36,952,142,299,0.475,99,189,0.524,43,110,0.391,73,101,0.723,62,158,220,23,31,28,39,81,400
Florida,3,Canyon Barry,35,747,122,289,0.422,80,164,0.488,42,125,0.336,113,128,0.883,29,68,97,22,18,13,31,41,399
Florida,4,Kasey Hill,36,1041,126,312,0.404,117,268,0.437,9,44,0.205,88,133,0.662,15,88,103,160,60,5,110,83,349
Florida,5,Justin Leon,36,804,92,213,0.432,43,90,0.478,49,123,0.398,34,43,0.791,49,96,145,17,17,5,28,82,267
Florida,6,Chris Chiozza,36,797,83,201,0.413,53,106,0.5,30,95,0.316,63,80,0.788,15,104,119,135,48,0,56,79,259
Florida,7,Kevarrius Hayes,36,659,77,128,0.602,77,127,0.606,0,1,0,68,101,0.673,69,91,160,7,24,59,28,85,222
Florida,8,John Egbunu,24,534,64,129,0.496,63,128,0.492,1,1,1,59,104,0.567,58,98,156,7,9,34,42,59,188
Florida,9,Keith Stone,34,410,44,104,0.423,29,58,0.5,15,46,0.326,20,31,0.645,28,45,73,18,11,7,23,46,123
Florida,10,Eric Hester,18,111,15,23,0.652,4,4,1,11,19,0.579,2,4,0.5,1,9,10,6,6,0,3,13,43
Florida,11,Schuyler Rimmer,21,111,9,20,0.45,9,19,0.474,0,1,0,8,13,0.615,9,10,19,2,1,3,5,21,26
Florida,12,Gorjok Gak,15,80,11,17,0.647,11,17,0.647,0,0,,1,10,0.1,11,12,23,0,1,3,7,13,23
Arkansas,1,Dusty Hannahs,36,890,168,383,0.439,94,192,0.49,74,191,0.387,108,119,0.908,19,42,61,42,16,4,60,63,518
Arkansas,2,Daryl Macon,36,908,141,311,0.453,76,143,0.531,65,168,0.387,136,157,0.866,19,76,95,80,41,2,65,65,483
Arkansas,3,Jaylen Barford,36,913,174,397,0.438,145,288,0.503,29,109,0.266,82,109,0.752,39,98,137,71,44,6,70,81,459
Arkansas,4,Moses Kingsley,36,999,149,319,0.467,142,303,0.469,7,16,0.438,128,169,0.757,79,199,278,48,23,93,70,99,433
Arkansas,5,Anton Beard,36,756,86,213,0.404,54,123,0.439,32,90,0.356,56,75,0.747,29,46,75,68,39,1,38,69,260
Arkansas,6,Manuale Watkins,36,802,93,165,0.564,80,137,0.584,13,28,0.464,17,30,0.567,37,107,144,65,45,1,20,70,216
Arkansas,7,Dustin Thomas,36,648,72,148,0.486,71,143,0.497,1,5,0.2,46,70,0.657,45,91,136,40,23,9,36,104,191
Arkansas,8,Arlando Cook,36,405,39,89,0.438,39,89,0.438,0,0,,24,37,0.649,29,54,83,12,10,14,23,63,102
Arkansas,9,Trey Thompson,36,503,34,54,0.63,34,53,0.642,0,1,0,19,29,0.655,30,87,117,56,23,28,22,79,87
Arkansas,10,C.J. Jones,21,127,17,36,0.472,5,12,0.417,12,24,0.5,5,7,0.714,0,13,13,6,1,5,4,11,51
Arkansas,11,Adrio Bailey,27,199,22,39,0.564,22,39,0.564,0,0,,6,19,0.316,13,22,35,7,13,7,11,29,50
Arkansas,12,Brachen Hazen,14,43,1,6,0.167,1,4,0.25,0,2,0,1,4,0.25,2,10,12,2,0,0,4,5,3
Arkansas,13,Jonathan Holmes,6,7,1,5,0.2,1,1,1,0,4,0,0,0,,0,1,1,0,0,0,0,1,2
South Carolina,1,Sindarius Thornwell,31,1051,195,438,0.445,137,291,0.471,58,147,0.395,215,259,0.83,78,144,222,87,66,30,76,71,663
South Carolina,2,PJ Dozier,36,1033,191,469,0.407,149,328,0.454,42,141,0.298,77,129,0.597,39,134,173,101,60,10,78,100,501
South Carolina,3,Chris Silva,37,775,123,234,0.526,123,233,0.528,0,1,0,134,178,0.753,85,140,225,13,22,51,69,141,380
South Carolina,4,Duane Notice,37,1210,122,311,0.392,53,109,0.486,69,202,0.342,64,95,0.674,31,63,94,86,37,7,52,53,377
South Carolina,5,Maik Kotsar,37,886,97,198,0.49,97,198,0.49,0,0,,21,53,0.396,72,104,176,26,27,14,44,117,215
South Carolina,6,Rakym Felder,36,538,61,150,0.407,27,70,0.386,34,80,0.425,44,67,0.657,7,46,53,47,21,4,49,51,200
South Carolina,7,Justin McKie,37,615,58,149,0.389,33,76,0.434,25,73,0.342,15,24,0.625,23,53,76,46,21,3,22,51,156
South Carolina,8,Hassani Gravett,35,594,40,134,0.299,25,65,0.385,15,69,0.217,20,31,0.645,16,41,57,49,14,1,37,48,115
South Carolina,9,Sedee Keita,29,279,12,44,0.273,12,43,0.279,0,1,0,8,18,0.444,20,38,58,3,7,11,15,40,32
South Carolina,10,TeMarcus Blanton,21,123,10,26,0.385,6,14,0.429,4,12,0.333,4,8,0.5,8,14,22,2,6,0,6,10,28
South Carolina,11,Ran Tut,12,73,6,15,0.4,6,14,0.429,0,1,0,0,0,,4,11,15,2,3,3,1,3,12
South Carolina,12,Khadim Gueye,28,208,3,12,0.25,3,12,0.25,0,0,,5,8,0.625,8,18,26,3,2,7,10,41,11
South Carolina,13,Evan Hinson,8,33,3,8,0.375,2,3,0.667,1,5,0.2,2,2,1,2,3,5,1,2,0,0,3,9
South Carolina,14,Jarrell Holliman,15,89,3,8,0.375,3,8,0.375,0,0,,2,2,1,4,6,10,2,0,1,2,17,8
South Carolina,15,Tommy Corchiani,5,11,0,0,,0,0,,0,0,,0,0,,0,1,1,0,0,0,1,4,0
South Carolina,16,Christian Schmitt,5,7,0,1,0,0,0,,0,1,0,0,0,,0,0,0,0,0,0,2,1,0
Ole Miss,1,Deandre Burnett,33,989,139,391,0.355,66,197,0.335,73,194,0.376,192,218,0.881,15,55,70,104,34,6,94,60,543
Ole Miss,2,Sebastian Saiz,36,1200,181,386,0.469,160,313,0.511,21,73,0.288,160,215,0.744,122,287,409,36,36,38,80,116,543
Ole Miss,3,Terence Davis,36,911,200,415,0.482,151,268,0.563,49,147,0.333,86,119,0.723,51,139,190,63,50,18,74,114,535
Ole Miss,4,Cullen Neal,36,846,99,241,0.411,36,87,0.414,63,154,0.409,78,89,0.876,10,51,61,77,16,1,54,72,339
Ole Miss,5,Breein Tyree,34,651,85,228,0.373,58,141,0.411,27,87,0.31,52,74,0.703,9,55,64,65,22,0,71,53,249
Ole Miss,6,Justas Furmanavicius,36,901,73,153,0.477,65,122,0.533,8,31,0.258,71,115,0.617,73,107,180,38,26,38,37,105,225
Ole Miss,7,Rasheed Brooks,33,737,74,211,0.351,32,88,0.364,42,123,0.341,21,23,0.913,22,64,86,53,27,6,44,44,211
Ole Miss,8,Marcanvis Hymon,36,784,51,100,0.51,51,99,0.515,0,1,0,23,57,0.404,64,116,180,20,26,37,40,105,125
Ole Miss,9,Donte Fitzpatrick-Dorsey,22,147,10,27,0.37,10,22,0.455,0,5,0,11,12,0.917,10,14,24,9,5,1,13,16,31
Ole Miss,10,Karlis Silins,8,39,1,3,0.333,1,3,0.333,0,0,,2,4,0.5,3,2,5,0,1,1,2,8,4
Ole Miss,11,Lane Below,4,9,1,2,0.5,1,2,0.5,0,0,,0,0,,0,0,0,0,0,0,0,1,2
Ole Miss,12,Nate Morris,7,36,0,5,0,0,5,0,0,0,,0,0,,2,5,7,0,0,3,3,8,0
Alabama,1,Braxton Key,34,1012,139,321,0.433,107,224,0.478,32,97,0.33,97,153,0.634,54,139,193,86,21,21,106,86,407
Alabama,2,Dazon Ingram,34,934,118,227,0.52,97,178,0.545,21,49,0.429,103,156,0.66,35,117,152,113,30,8,85,88,360
Alabama,3,Riley Norris,34,929,105,258,0.407,58,117,0.496,47,141,0.333,48,65,0.738,41,88,129,25,23,4,38,76,305
Alabama,4,Avery Johnson,34,664,84,254,0.331,51,148,0.345,33,106,0.311,32,42,0.762,11,46,57,49,25,1,36,58,233
Alabama,5,Corban Collins,32,698,70,199,0.352,25,70,0.357,45,129,0.349,39,60,0.65,9,49,58,47,18,0,30,58,224
Alabama,6,Donta Hall,34,670,79,120,0.658,79,120,0.658,0,0,,45,75,0.6,66,120,186,18,18,48,31,86,203
Alabama,7,Ar'Mond Davis,32,440,67,201,0.333,35,81,0.432,32,120,0.267,27,33,0.818,7,40,47,4,13,3,20,22,193
Alabama,8,Jimmie Taylor,34,612,71,123,0.577,71,123,0.577,0,0,,31,63,0.492,41,85,126,20,15,46,38,85,173
Alabama,9,Bola Olaniyan,33,530,39,76,0.513,39,76,0.513,0,0,,24,40,0.6,89,123,212,13,23,1,43,69,102
Alabama,10,Shannon Hale,21,245,24,76,0.316,16,35,0.457,8,41,0.195,31,44,0.705,6,25,31,6,5,6,22,29,87
Alabama,11,Nick King,7,89,8,25,0.32,5,12,0.417,3,13,0.231,4,6,0.667,3,17,20,3,5,2,7,3,23
Alabama,12,Lawson Schaffer,15,28,4,10,0.4,0,2,0,4,8,0.5,4,4,1,1,3,4,5,3,0,1,1,16
Alabama,13,Brandon Austin,7,45,1,19,0.053,1,13,0.077,0,6,0,2,5,0.4,2,2,4,1,1,1,1,3,4
Alabama,14,Landon Fuller,2,4,0,0,,0,0,,0,0,,0,0,,0,0,0,0,0,0,0,0,0
Vanderbilt,1,Matthew Fisher-Davis,34,947,145,359,0.404,61,133,0.459,84,226,0.372,98,121,0.81,11,98,109,35,21,8,52,70,472
Vanderbilt,2,Luke Kornet,35,1101,145,357,0.406,92,195,0.472,53,162,0.327,120,140,0.857,53,164,217,43,19,71,45,81,463
Vanderbilt,3,Jeff Roberson,35,1108,122,293,0.416,83,178,0.466,39,115,0.339,96,121,0.793,70,176,246,61,29,13,64,91,379
Vanderbilt,4,Riley LaChance,35,1090,115,247,0.466,45,103,0.437,70,144,0.486,68,78,0.872,7,108,115,137,21,1,67,73,368
Vanderbilt,5,Nolan Cressler,35,828,107,208,0.514,72,127,0.567,35,81,0.432,23,33,0.697,28,118,146,61,19,1,45,61,272
Vanderbilt,6,Joe Toye,35,739,70,175,0.4,39,97,0.402,31,78,0.397,53,78,0.679,21,71,92,38,14,5,44,70,224
Vanderbilt,7,Payton Willis,35,614,62,142,0.437,37,62,0.597,25,80,0.313,32,51,0.627,12,51,63,64,16,6,56,35,181
Vanderbilt,8,Djery Baptiste,35,274,25,48,0.521,25,48,0.521,0,0,,13,20,0.65,25,40,65,1,4,14,24,59,63
Vanderbilt,9,Clevon Brown,34,259,20,51,0.392,12,24,0.5,8,27,0.296,7,12,0.583,16,34,50,3,1,14,16,35,55
Vanderbilt,10,Camron Justice,7,65,4,16,0.25,3,8,0.375,1,8,0.125,3,6,0.5,0,6,6,7,3,0,4,5,12
Vanderbilt,11,Phillip McGloin,2,0,0,0,,0,0,,0,0,,0,0,,0,0,0,0,0,0,0,1,0
Georgia,1,J.J. Frazier,34,1178,199,490,0.406,144,309,0.466,55,181,0.304,187,211,0.886,12,117,129,141,63,4,80,81,640
Georgia,2,Yante Maten,29,842,179,345,0.519,158,302,0.523,21,43,0.488,149,208,0.716,72,125,197,43,21,43,72,80,528
Georgia,3,Juwan Parker,32,857,106,277,0.383,98,226,0.434,8,51,0.157,77,90,0.856,35,136,171,56,19,2,54,70,297
Georgia,4,Derek Ogbeide,34,788,101,178,0.567,101,178,0.567,0,0,,38,66,0.576,78,181,259,20,12,39,43,93,240
Georgia,5,Mike Edwards,34,615,55,105,0.524,55,104,0.529,0,1,0,38,61,0.623,38,86,124,7,10,7,36,74,148
Georgia,6,Jordan Harris,30,494,46,106,0.434,24,57,0.421,22,49,0.449,27,37,0.73,7,35,42,45,16,6,56,47,141
Georgia,7,William Jackson II,34,594,48,135,0.356,22,59,0.373,26,76,0.342,17,24,0.708,7,33,40,37,14,7,26,40,139
Georgia,8,Tyree Crump,28,207,33,95,0.347,14,37,0.378,19,58,0.328,16,18,0.889,3,16,19,13,3,0,14,11,101
Georgia,9,Pape Diatta,33,357,28,69,0.406,20,42,0.476,8,27,0.296,23,31,0.742,9,53,62,18,5,4,25,38,87
Georgia,10,E'Torrion Wilridge,29,470,22,48,0.458,13,21,0.619,9,27,0.333,7,17,0.412,5,42,47,34,11,11,18,26,60
Georgia,11,Kenny Paul Geno,28,252,14,32,0.438,7,13,0.538,7,19,0.368,6,9,0.667,6,30,36,15,4,3,2,35,41
Georgia,12,Houston Kessler,29,183,5,18,0.278,5,13,0.385,0,5,0,3,5,0.6,8,23,31,0,4,0,3,35,13
Georgia,13,Connor O'Neill,4,6,0,1,0,0,1,0,0,0,,0,0,,0,3,3,0,0,0,2,2,0
Georgia,14,Brandon Young,7,9,0,4,0,0,3,0,0,1,0,0,0,,0,1,1,0,0,0,0,0,0
Texas A&M,1,Tyler Davis,31,812,167,270,0.619,167,269,0.621,0,1,0,106,153,0.693,95,121,216,44,15,30,83,82,440
Texas A&M,2,Admon Gilder,31,1073,146,340,0.429,88,186,0.473,58,154,0.377,75,101,0.743,32,88,120,120,60,9,83,69,425
Texas A&M,3,Robert Williams,31,801,153,275,0.556,151,257,0.588,2,18,0.111,59,100,0.59,94,158,252,44,21,76,54,57,367
Texas A&M,4,DJ Hogg,22,652,97,244,0.398,53,124,0.427,44,120,0.367,25,44,0.568,29,83,112,75,21,21,59,46,263
Texas A&M,5,Tonny Trocha-Morelos,31,835,97,239,0.406,74,153,0.484,23,86,0.267,35,52,0.673,50,111,161,66,26,30,48,60,252
Texas A&M,6,J.C. Hampton,31,776,60,153,0.392,17,49,0.347,43,104,0.413,44,56,0.786,4,57,61,56,17,0,35,62,207
Texas A&M,7,Tavario Miller,31,324,38,80,0.475,38,79,0.481,0,1,0,19,39,0.487,31,53,84,6,4,4,19,44,95
Texas A&M,8,Eric Vila,20,237,15,51,0.294,9,28,0.321,6,23,0.261,9,16,0.563,4,36,40,18,10,0,13,16,45
Texas A&M,9,Chris Collins,27,369,13,43,0.302,5,10,0.5,8,33,0.242,3,7,0.429,2,26,28,39,6,2,24,37,37
Texas A&M,10,Caleb Smith,14,101,9,22,0.409,7,14,0.5,2,8,0.25,3,6,0.5,1,11,12,7,3,0,3,7,23
Texas A&M,11,Kobie Eubanks,16,117,7,29,0.241,5,8,0.625,2,21,0.095,0,5,0,6,9,15,2,0,1,8,9,16
Texas A&M,12,Mark French,3,4,1,3,0.333,0,1,0,1,2,0.5,1,2,0.5,0,0,0,0,0,0,1,1,4
Texas A&M,13,Chase Carlton,12,94,1,5,0.2,1,2,0.5,0,3,0,0,3,0,0,4,4,11,3,0,3,21,2
Texas A&M,14,Frank Byers,3,3,0,0,,0,0,,0,0,,0,0,,0,1,1,1,0,0,1,0,0
Texas A&M,15,Kyle Nugent,2,2,0,0,,0,0,,0,0,,0,0,,0,0,0,0,0,0,0,0,0
Tennessee,1,Robert Hubbs,32,1011,170,364,0.467,166,338,0.491,4,26,0.154,93,111,0.838,40,107,147,53,23,7,47,56,437
Tennessee,2,Grant Williams,32,814,132,262,0.504,120,230,0.522,12,32,0.375,126,189,0.667,94,95,189,36,26,61,62,105,402
Tennessee,3,Lamonte Turner,32,662,76,214,0.355,35,89,0.393,41,125,0.328,70,91,0.769,10,71,81,86,19,7,55,67,263
Tennessee,4,Jordan Bowden,30,683,75,202,0.371,40,91,0.44,35,111,0.315,53,63,0.841,24,63,87,40,27,5,22,62,238
Tennessee,5,Admiral Schofield,28,533,78,172,0.453,57,118,0.483,21,54,0.389,53,68,0.779,26,98,124,21,9,5,32,65,230
Tennessee,6,Shembari Phillips,31,645,58,151,0.384,40,103,0.388,18,48,0.375,58,75,0.773,21,74,95,52,19,4,44,74,192
Tennessee,7,Jordan Bone,23,450,61,164,0.372,47,118,0.398,14,46,0.304,30,39,0.769,6,33,39,66,12,0,32,29,166
Tennessee,8,Detrick Mostella,15,323,53,131,0.405,27,61,0.443,26,70,0.371,26,37,0.703,8,51,59,18,6,6,22,31,158
Tennessee,9,Lew Evans,32,475,30,87,0.345,17,43,0.395,13,44,0.295,37,54,0.685,35,56,91,30,10,7,26,74,110
Tennessee,10,Kyle Alexander,32,447,41,88,0.466,40,82,0.488,1,6,0.167,22,44,0.5,57,72,129,6,6,31,15,53,105
Tennessee,11,John Fulkerson,10,160,17,30,0.567,17,30,0.567,0,0,,13,20,0.65,14,32,46,10,11,9,8,23,47
Tennessee,12,Kwe Parker,25,202,10,31,0.323,7,18,0.389,3,13,0.231,1,8,0.125,4,17,21,22,6,3,23,30,24
Tennessee,13,Brad Woodson,5,14,2,7,0.286,1,3,0.333,1,4,0.25,2,2,1,0,0,0,1,1,1,0,1,7
Tennessee,14,Lucas Campbell,3,5,0,0,,0,0,,0,0,,4,6,0.667,0,0,0,0,0,0,0,0,4
Auburn,1,Mustapha Heron,32,901,152,344,0.442,108,240,0.45,44,104,0.423,137,178,0.77,52,143,195,41,27,6,77,87,485
Auburn,2,Jared Harper,32,773,104,270,0.385,50,113,0.442,54,157,0.344,103,146,0.705,10,52,62,95,37,2,49,57,365
Auburn,3,Danjel Purifoy,29,831,97,244,0.398,38,84,0.452,59,160,0.369,80,91,0.879,28,108,136,51,41,5,45,65,333
Auburn,4,T.J. Dunans,31,754,105,271,0.387,90,199,0.452,15,72,0.208,29,53,0.547,15,93,108,76,31,22,72,65,254
Auburn,5,Ronnie Johnson,32,525,91,210,0.433,66,144,0.458,25,66,0.379,43,60,0.717,16,41,57,74,22,0,37,32,250
Auburn,6,Bryce Brown,28,592,68,189,0.36,12,49,0.245,56,140,0.4,18,27,0.667,12,43,55,35,26,6,26,49,210
Auburn,7,Austin Wiley,23,414,73,125,0.584,73,125,0.584,0,0,,56,114,0.491,52,56,108,5,5,31,41,59,202
Auburn,8,Anfernee McLemore,32,482,69,101,0.683,68,100,0.68,1,1,1,35,58,0.603,54,89,143,4,13,37,28,76,174
Auburn,9,TJ Lang,29,476,35,88,0.398,5,12,0.417,30,76,0.395,26,39,0.667,16,35,51,14,10,2,16,55,126
Auburn,10,Horace Spencer,19,309,37,66,0.561,37,65,0.569,0,1,0,18,36,0.5,23,42,65,10,14,28,18,58,92
Auburn,11,LaRon Smith,24,288,24,45,0.533,24,45,0.533,0,0,,15,29,0.517,29,28,57,6,7,23,16,56,63
Auburn,12,Will Macoy,4,8,3,6,0.5,1,1,1,2,5,0.4,0,0,,0,1,1,0,1,0,0,0,8
Auburn,13,Devin Waddell,10,75,2,6,0.333,0,2,0,2,4,0.5,1,3,0.333,1,5,6,3,0,0,3,6,7
Auburn,14,Patrick Keim,5,9,1,3,0.333,0,1,0,1,2,0.5,1,2,0.5,0,3,3,1,0,0,1,0,4
Auburn,15,Cole Blackstock,3,5,0,0,,0,0,,0,0,,0,0,,0,2,2,0,0,0,0,2,0
Auburn,16,Mike Cohen,2,4,0,0,,0,0,,0,0,,0,0,,0,0,0,1,0,0,0,0,0
Auburn,17,Trey Tate,2,4,0,1,0,0,0,,0,1,0,0,0,,0,0,0,0,0,0,0,1,0
Mississippi State,1,Quinndary Weatherspoon,29,926,173,369,0.469,126,243,0.519,47,126,0.373,85,111,0.766,40,108,148,53,50,9,64,68,478
Mississippi State,2,Lamar Peters,30,738,103,266,0.387,44,105,0.419,59,161,0.366,56,75,0.747,12,56,68,101,34,5,68,81,321
Mississippi State,3,Mario Kegler,32,901,106,252,0.421,66,136,0.485,40,116,0.345,58,88,0.659,37,138,175,37,22,8,60,78,310
Mississippi State,4,Aric Holman,32,747,105,211,0.498,93,162,0.574,12,49,0.245,49,75,0.653,57,136,193,20,21,63,54,79,271
Mississippi State,5,Tyson Carter,32,645,84,211,0.398,40,89,0.449,44,122,0.361,27,33,0.818,5,50,55,22,23,4,14,45,239
Mississippi State,6,I.J. Ready,28,801,79,188,0.42,68,144,0.472,11,44,0.25,50,58,0.862,8,68,76,127,45,1,54,36,219
Mississippi State,7,Schnider Herard,32,595,56,102,0.549,56,102,0.549,0,0,,51,103,0.495,58,101,159,7,3,8,48,68,163
Mississippi State,8,Xavian Stapleton,23,385,58,128,0.453,40,74,0.541,18,54,0.333,28,44,0.636,24,42,66,7,22,10,21,66,162
Mississippi State,9,Eli Wright,30,392,36,68,0.529,25,41,0.61,11,27,0.407,22,31,0.71,14,33,47,7,11,2,16,50,105
Mississippi State,10,E.J. Datcher,31,228,13,32,0.406,13,32,0.406,0,0,,5,9,0.556,13,34,47,1,6,19,9,59,31
Mississippi State,11,Drew Davis,6,12,4,8,0.5,1,4,0.25,3,4,0.75,0,0,,1,0,1,2,1,0,2,0,11
Mississippi State,12,L.J. Singleton,7,27,2,7,0.286,1,3,0.333,1,4,0.25,0,0,,1,3,4,2,1,1,1,3,5
Mississippi State,13,Joe Strugg,6,15,1,4,0.25,0,1,0,1,3,0.333,0,0,,0,3,3,0,0,0,4,2,3
Mississippi State,14,Miles Washington,6,13,1,3,0.333,1,2,0.5,0,1,0,0,0,,0,0,0,0,0,1,0,3,2
LSU,1,Antonio Blakeney,31,1018,194,424,0.458,141,276,0.511,53,148,0.358,92,127,0.724,32,117,149,54,21,3,64,49,533
LSU,2,Duop Reath,31,859,157,308,0.51,146,273,0.535,11,35,0.314,47,78,0.603,63,128,191,25,16,46,66,105,372
LSU,3,Brandon Sampson,31,853,120,254,0.472,81,139,0.583,39,115,0.339,78,100,0.78,18,78,96,42,19,14,63,55,357
LSU,4,Skylar Mays,31,711,84,203,0.414,63,139,0.453,21,64,0.328,69,85,0.812,16,53,69,113,40,2,69,55,258
LSU,5,Wayde Sims,31,588,77,153,0.503,63,119,0.529,14,34,0.412,32,43,0.744,39,78,117,17,22,14,32,53,200
LSU,6,Aaron Epps,30,515,71,144,0.493,57,112,0.509,14,32,0.438,29,43,0.674,55,78,133,13,5,11,41,85,185
LSU,7,Jalyn Patterson,31,689,65,171,0.38,36,71,0.507,29,100,0.29,20,32,0.625,14,80,94,93,38,3,54,41,179
LSU,8,Craig Victor,8,202,32,79,0.405,32,77,0.416,0,2,0,20,30,0.667,23,38,61,8,10,5,12,22,84
LSU,9,Elbert Robinson,22,140,17,28,0.607,17,28,0.607,0,0,,12,29,0.414,13,18,31,6,3,6,20,39,46
LSU,10,Kieran Hayward,26,214,10,45,0.222,1,14,0.071,9,31,0.29,3,5,0.6,9,20,29,8,4,3,4,31,32
LSU,11,Brian Bridgewater,23,104,10,21,0.476,10,21,0.476,0,0,,6,7,0.857,7,11,18,3,2,1,6,21,26
LSU,12,Branden Jenkins,19,152,8,40,0.2,4,27,0.148,4,13,0.308,4,11,0.364,3,8,11,11,5,1,7,18,24
LSU,13,Brandon Eddlestone,12,100,7,14,0.5,5,10,0.5,2,4,0.5,2,4,0.5,15,11,26,1,0,1,3,12,18
LSU,14,Marshall Graves,15,48,1,9,0.111,1,3,0.333,0,6,0,2,3,0.667,1,4,5,3,1,0,3,7,4
LSU,15,Reed Vial,6,7,0,0,,0,0,,0,0,,1,2,0.5,0,1,1,0,0,0,1,0,1
Missouri,1,Kevin Puryear,32,946,132,323,0.409,112,261,0.429,20,62,0.323,92,125,0.736,58,133,191,30,12,10,56,77,376
Missouri,2,Terrence Phillips,32,907,100,274,0.365,47,125,0.376,53,149,0.356,81,102,0.794,7,110,117,142,44,4,79,114,334
Missouri,3,Jordan Barnett,23,630,101,231,0.437,65,111,0.586,36,120,0.3,43,55,0.782,42,90,132,13,14,10,30,47,281
Missouri,4,Frankie Hughes,30,578,77,260,0.296,32,92,0.348,45,168,0.268,30,53,0.566,14,64,78,35,19,2,39,44,229
Missouri,5,Jordan Geist,32,707,66,182,0.363,44,105,0.419,22,77,0.286,71,94,0.755,10,84,94,63,22,0,38,53,225
Missouri,6,K.J. Walton,32,608,69,175,0.394,64,152,0.421,5,23,0.217,70,116,0.603,44,62,106,31,37,0,37,53,213
Missouri,7,Russell Woods,32,710,73,151,0.483,73,151,0.483,0,0,,67,114,0.588,71,67,138,12,11,5,34,107,213
Missouri,8,Cullen VanLeer,32,759,58,160,0.363,14,28,0.5,44,132,0.333,20,24,0.833,6,51,57,43,23,8,26,66,180
Missouri,9,Reed Nikko,27,294,28,55,0.509,28,55,0.509,0,0,,13,25,0.52,24,39,63,10,8,19,12,48,69
Missouri,10,Willie Jackson,11,186,29,53,0.547,29,52,0.558,0,1,0,7,10,0.7,15,36,51,4,3,6,13,18,65
Missouri,11,Mitchell Smith,11,83,10,17,0.588,10,17,0.588,0,0,,6,14,0.429,3,16,19,2,3,4,7,16,26
Missouri,12,Adam Wolf,10,22,1,5,0.2,1,3,0.333,0,2,0,0,0,,3,0,3,0,1,0,0,3,2
Missouri,13,Trevor Glassman,7,13,0,6,0,0,1,0,0,5,0,0,0,,2,3,5,1,2,0,2,1,0
Missouri,14,Jakoby Kemp,1,0,0,0,,0,0,,0,0,,0,0,,0,0,0,0,0,0,0,0,0
Missouri,15,Brett Rau,5,7,0,1,0,0,1,0,0,0,,0,0,,2,0,2,0,1,0,1,0,0
Arizona,1,Lauri Markkanen,37,1140,185,376,0.492,116,213,0.545,69,163,0.423,137,164,0.835,88,178,266,32,15,19,40,73,576
Arizona,2,Rawle Alkins,37,1037,143,309,0.463,99,190,0.521,44,119,0.37,74,101,0.733,57,126,183,76,33,17,67,81,404
Arizona,3,Dusan Ristic,36,822,164,295,0.556,163,293,0.556,1,2,0.5,62,81,0.765,63,134,197,16,11,16,39,76,391
Arizona,4,Kadeem Allen,34,1020,107,236,0.453,75,161,0.466,32,75,0.427,86,116,0.741,12,125,137,101,53,21,65,83,332
Arizona,5,Kobi Simmons,37,871,112,282,0.397,80,184,0.435,32,98,0.327,69,89,0.775,13,47,60,73,24,3,46,70,325
Arizona,6,Allonzo Trier,18,575,91,198,0.46,57,111,0.514,34,87,0.391,94,116,0.81,5,91,96,48,7,2,31,32,310
Arizona,7,Chance Comanche,37,671,89,156,0.571,89,156,0.571,0,0,,54,74,0.73,40,93,133,13,5,14,38,80,232
Arizona,8,Parker Jackson-Cartwright,31,773,57,133,0.429,27,62,0.435,30,71,0.423,38,54,0.704,10,66,76,127,37,4,41,55,182
Arizona,9,Keanu Pinder,35,421,28,53,0.528,27,49,0.551,1,4,0.25,19,33,0.576,32,68,100,11,16,22,29,69,76
Arizona,10,Kory Jones,4,7,1,1,1,0,0,,1,1,1,0,0,,0,0,0,0,0,1,0,0,3
Arizona,11,Jake Desjardins,6,12,0,2,0,0,2,0,0,0,,2,2,1,0,1,1,0,0,0,2,3,2
Arizona,12,Paulo Cruz,8,20,0,4,0,0,2,0,0,2,0,0,0,,0,3,3,0,0,0,4,2,0
Arizona,13,Tyler Trillo,8,31,0,3,0,0,0,,0,3,0,0,0,,0,0,0,4,0,0,1,1,0
Oregon,1,Tyler Dorsey,39,1169,189,405,0.467,101,197,0.513,88,208,0.423,105,139,0.755,33,102,135,67,30,4,59,57,571
Oregon,2,Dillon Brooks,35,886,206,422,0.488,149,280,0.532,57,142,0.401,95,126,0.754,35,78,113,95,38,18,72,97,564
Oregon,3,Jordan Bell,39,1124,171,269,0.636,168,255,0.659,3,14,0.214,82,117,0.701,112,230,342,70,49,87,75,69,427
Oregon,4,Dylan Ennis,39,1237,144,336,0.429,91,188,0.484,53,148,0.358,84,114,0.737,28,144,172,119,43,17,71,65,425
Oregon,5,Chris Boucher,31,731,141,269,0.524,105,166,0.633,36,103,0.35,48,85,0.565,54,134,188,13,12,79,32,83,366
Oregon,6,Payton Pritchard,39,1105,97,245,0.396,47,102,0.461,50,143,0.35,46,63,0.73,23,108,131,140,45,3,56,87,290
Oregon,7,Casey Benson,39,816,61,140,0.436,29,61,0.475,32,79,0.405,37,48,0.771,13,52,65,74,25,1,34,51,191
Oregon,8,Kavell Bigby-Williams,37,363,35,77,0.455,35,77,0.455,0,0,,41,66,0.621,33,70,103,7,3,26,22,54,111
Oregon,9,Roman Sorkin,23,184,24,53,0.453,14,32,0.438,10,21,0.476,15,16,0.938,18,25,43,12,0,8,8,21,73
Oregon,10,Keith Smith,28,175,21,48,0.438,18,31,0.581,3,17,0.176,7,13,0.538,11,15,26,17,7,5,11,27,52
Oregon,11,Evan Gross,2,4,1,1,1,0,0,,1,1,1,0,0,,0,1,1,0,0,0,1,0,3
Oregon,12,Charlie Noebel,14,31,1,5,0.2,0,1,0,1,4,0.25,0,0,,0,4,4,0,1,0,2,3,3
UCLA,1,TJ Leaf,35,1048,235,381,0.617,208,323,0.644,27,58,0.466,72,106,0.679,78,209,287,85,22,39,52,89,569
UCLA,2,Bryce Alford,36,1188,173,387,0.447,57,117,0.487,116,270,0.43,96,117,0.821,11,78,89,92,19,5,35,51,558
UCLA,3,Lonzo Ball,36,1263,189,343,0.551,109,149,0.732,80,194,0.412,66,98,0.673,33,183,216,274,66,28,89,65,524
UCLA,4,Isaac Hamilton,36,1080,193,426,0.453,119,224,0.531,74,202,0.366,47,57,0.825,30,98,128,99,25,6,71,63,507
UCLA,5,Aaron Holiday,36,952,150,309,0.485,97,180,0.539,53,129,0.411,88,111,0.793,12,91,103,158,39,6,87,81,441
UCLA,6,Thomas Welsh,32,802,151,258,0.585,150,257,0.584,1,1,1,42,47,0.894,70,207,277,32,11,43,14,81,345
UCLA,7,Ike Anigbogu,29,377,57,101,0.564,57,101,0.564,0,0,,23,43,0.535,41,76,117,6,5,35,24,72,137
UCLA,8,Gyorgy Goloman,35,401,54,93,0.581,53,83,0.639,1,10,0.1,21,33,0.636,26,59,85,23,21,29,23,69,130
UCLA,9,Jerrold Smith,12,25,3,11,0.273,3,9,0.333,0,2,0,1,2,0.5,0,0,0,1,2,0,2,5,7
UCLA,10,Alec Wulff,11,22,2,6,0.333,0,0,,2,6,0.333,0,0,,0,1,1,1,1,0,0,2,6
UCLA,11,Isaac Wulff,5,9,2,2,1,2,2,1,0,0,,1,2,0.5,1,1,2,0,0,0,0,1,5
UCLA,12,Armani Dodson,1,2,1,1,1,1,1,1,0,0,,0,0,,1,0,1,0,0,0,0,0,2
UCLA,13,Ikenna Okwarabizie,12,31,0,2,0,0,2,0,0,0,,2,6,0.333,1,6,7,0,1,0,3,4,2
Utah,1,Kyle Kuzma,29,894,182,361,0.504,155,277,0.56,27,84,0.321,85,127,0.669,81,190,271,71,18,14,62,46,476
Utah,2,Lorenzo Bonam,32,954,144,251,0.574,114,164,0.695,30,87,0.345,83,104,0.798,17,81,98,98,45,11,70,58,401
Utah,3,David Collette,22,558,124,207,0.599,122,204,0.598,2,3,0.667,50,80,0.625,39,74,113,23,17,20,34,73,300
Utah,4,Devon Daniels,29,779,113,198,0.571,99,163,0.607,14,35,0.4,46,65,0.708,25,108,133,78,25,13,57,63,286
Utah,5,JoJo Zamora,32,641,80,176,0.455,48,87,0.552,32,89,0.36,30,37,0.811,9,37,46,35,18,8,38,44,222
Utah,6,Sedrick Barefield,24,542,70,168,0.417,37,84,0.44,33,84,0.393,42,57,0.737,8,36,44,47,19,0,44,43,215
Utah,7,Tyler Rawson,32,625,65,146,0.445,46,82,0.561,19,64,0.297,43,63,0.683,34,83,117,60,20,17,42,67,192
Utah,8,Parker Van Dyke,31,537,54,136,0.397,24,50,0.48,30,86,0.349,6,13,0.462,3,55,58,39,16,3,12,29,144
Utah,9,Jayce Johnson,32,393,52,92,0.565,52,92,0.565,0,0,,23,53,0.434,43,95,138,4,4,20,28,67,127
Utah,10,Gabe Bealer,28,338,36,84,0.429,15,28,0.536,21,56,0.375,9,12,0.75,7,44,51,13,9,2,16,22,102
Utah,11,Jake Connor,14,75,9,19,0.474,2,2,1,7,17,0.412,0,1,0,0,4,4,6,3,0,3,8,25
Utah,12,Jakub Jokl,12,46,4,7,0.571,4,7,0.571,0,0,,5,8,0.625,1,14,15,1,0,4,3,14,13
Utah,13,Marc Reininger,11,32,2,4,0.5,2,4,0.5,0,0,,0,0,,3,1,4,0,0,1,4,3,4
Utah,14,Beau Rydalch,10,34,1,7,0.143,1,3,0.333,0,4,0,2,2,1,4,4,8,1,1,0,3,2,4
USC,1,Chimezie Metu,36,1128,202,366,0.552,201,364,0.552,1,2,0.5,129,174,0.741,73,207,280,50,28,55,76,89,534
USC,2,Jordan McLaughlin,36,1228,162,353,0.459,115,236,0.487,47,117,0.402,95,119,0.798,29,99,128,197,53,4,80,35,466
USC,3,Elijah Stewart,36,1073,154,357,0.431,76,155,0.49,78,202,0.386,57,81,0.704,45,96,141,43,29,42,37,94,443
USC,4,De'Anthony Melton,36,972,101,231,0.437,80,157,0.51,21,74,0.284,77,109,0.706,50,120,170,125,69,37,64,81,300
USC,5,Bennie Boatwright,19,524,86,201,0.428,39,72,0.542,47,129,0.364,68,75,0.907,29,57,86,32,8,7,30,40,287
USC,6,Shaqquan Aaron,36,748,91,232,0.392,54,122,0.443,37,110,0.336,54,75,0.72,31,81,112,41,14,6,37,48,273
USC,7,Jonah Mathews,35,715,83,223,0.372,41,96,0.427,42,127,0.331,36,52,0.692,14,50,64,40,31,2,22,47,244
USC,8,Nick Rakocevic,36,538,67,119,0.563,67,119,0.563,0,0,,53,79,0.671,60,74,134,16,9,23,31,89,187
USC,9,Charles Buggs,24,213,21,36,0.583,14,22,0.636,7,14,0.5,7,9,0.778,9,33,42,4,8,10,9,38,56
USC,10,Harrison Henderson,13,50,5,14,0.357,3,9,0.333,2,5,0.4,5,12,0.417,1,11,12,2,2,4,2,5,17
USC,11,Kurt Karis,13,23,2,3,0.667,2,3,0.667,0,0,,2,2,1,1,0,1,0,0,0,3,5,6
USC,12,Samer Dhillon,7,9,1,3,0.333,0,1,0,1,2,0.5,0,0,,0,2,2,0,0,0,0,0,3
USC,13,Devin Fleming,4,6,0,1,0,0,1,0,0,0,,0,0,,0,2,2,0,1,0,0,0,0
California,1,Ivan Rabb,31,1012,151,312,0.484,143,292,0.49,8,20,0.4,124,187,0.663,94,230,324,48,21,31,67,96,434
California,2,Charlie Moore,34,980,136,349,0.39,91,221,0.412,45,128,0.352,99,131,0.756,12,55,67,119,37,0,99,87,416
California,3,Jabari Bird,27,863,140,319,0.439,75,140,0.536,65,179,0.363,42,55,0.764,26,101,127,28,18,6,50,52,387
California,4,Grant Mullins,32,1000,106,252,0.421,35,87,0.402,71,165,0.43,45,56,0.804,7,96,103,64,30,3,38,57,328
California,5,Kingsley Okoroh,34,722,64,127,0.504,64,127,0.504,0,0,,30,56,0.536,72,116,188,31,12,74,42,88,158
California,6,Sam Singer,34,682,63,144,0.438,53,106,0.5,10,38,0.263,16,37,0.432,12,88,100,67,23,2,39,62,152
California,7,Don Coleman,27,309,42,112,0.375,38,92,0.413,4,20,0.2,35,57,0.614,14,27,41,15,4,1,28,44,123
California,8,Kameron Rooks,24,411,41,75,0.547,41,75,0.547,0,0,,36,60,0.6,42,65,107,8,4,22,20,60,118
California,9,Roger Moute a Bidias,30,358,22,71,0.31,13,36,0.361,9,35,0.257,31,36,0.861,18,36,54,9,5,4,18,38,84
California,10,Stephen Domingo,31,419,23,106,0.217,10,35,0.286,13,71,0.183,15,33,0.455,13,53,66,18,10,11,6,50,74
California,11,Cole Welle,12,50,11,20,0.55,11,18,0.611,0,2,0,0,3,0,9,10,19,0,1,1,0,9,22
California,12,Roman Davis,14,48,7,17,0.412,7,16,0.438,0,1,0,1,5,0.2,3,8,11,0,0,0,2,8,15
California,13,Nick Hamilton,10,36,1,6,0.167,0,1,0,1,5,0.2,1,2,0.5,3,1,4,2,0,0,1,4,4
California,14,Koko Kurdoghlian,5,9,0,1,0,0,1,0,0,0,,1,2,0.5,0,0,0,0,0,0,0,1,1
Colorado,1,Derrick White,34,1116,205,404,0.507,148,260,0.569,57,144,0.396,148,182,0.813,35,104,139,148,42,49,81,73,615
Colorado,2,Xavier Johnson,32,895,164,335,0.49,125,233,0.536,39,102,0.382,106,157,0.675,55,135,190,33,17,11,47,82,473
Colorado,3,George King,34,943,139,302,0.46,92,177,0.52,47,125,0.376,53,79,0.671,67,163,230,25,16,7,57,72,378
Colorado,4,Wesley Gordon,32,786,79,154,0.513,77,148,0.52,2,6,0.333,56,84,0.667,73,130,203,62,15,48,42,86,216
Colorado,5,Josh Fortune,34,691,63,178,0.354,32,76,0.421,31,102,0.304,48,56,0.857,23,80,103,51,13,10,44,55,205
Colorado,6,Tory Miller,32,506,73,136,0.537,72,133,0.541,1,3,0.333,33,62,0.532,38,89,127,16,9,7,27,81,180
Colorado,7,Dominique Collier,25,463,44,130,0.338,18,52,0.346,26,78,0.333,37,50,0.74,6,22,28,40,24,3,27,45,151
Colorado,8,Bryce Peters,24,379,40,102,0.392,27,63,0.429,13,39,0.333,20,36,0.556,7,26,33,24,10,1,17,37,113
Colorado,9,Deleon Brown,31,371,32,87,0.368,16,36,0.444,16,51,0.314,19,27,0.704,8,14,22,19,11,3,17,30,99
Colorado,10,Lucas Siewert,32,369,30,95,0.316,13,49,0.265,17,46,0.37,9,14,0.643,23,44,67,15,5,4,16,28,86
Colorado,11,Thomas Akyazili,30,313,19,65,0.292,18,44,0.409,1,21,0.048,13,23,0.565,8,22,30,39,10,3,26,41,52
Colorado,12,Mitch Lombard,6,9,0,1,0,0,1,0,0,0,,0,0,,0,1,1,2,0,0,1,1,0
Colorado,13,Josh Repine,6,9,0,4,0,0,3,0,0,1,0,0,0,,0,0,0,0,0,0,1,1,0
Arizona State,1,Torian Graham,33,1147,230,513,0.448,122,234,0.521,108,279,0.387,46,56,0.821,19,120,139,39,31,11,44,51,614
Arizona State,2,Tra Holder,33,1175,169,390,0.433,123,265,0.464,46,125,0.368,152,197,0.772,38,83,121,106,29,1,66,68,536
Arizona State,3,Shannon Evans,33,1179,161,392,0.411,89,191,0.466,72,201,0.358,100,120,0.833,17,93,110,144,42,7,62,61,494
Arizona State,4,Obinna Oleka,33,1085,141,328,0.43,117,233,0.502,24,95,0.253,105,146,0.719,98,229,327,38,32,27,63,81,411
Arizona State,5,Kodi Justice,33,1025,99,235,0.421,36,84,0.429,63,151,0.417,41,55,0.745,13,81,94,80,44,19,53,106,302
Arizona State,6,Sam Cunliffe,10,254,31,89,0.348,16,52,0.308,15,37,0.405,18,29,0.621,6,42,48,14,5,3,18,26,95
Arizona State,7,Ramon Vila,33,407,33,51,0.647,33,48,0.688,0,3,0,21,33,0.636,38,28,66,2,5,8,11,86,87
Arizona State,8,Jethro Tshisumpa,26,192,11,26,0.423,11,26,0.423,0,0,,3,9,0.333,16,23,39,0,4,25,8,55,25
Arizona State,9,Andre Adams,14,80,9,12,0.75,9,12,0.75,0,0,,1,6,0.167,9,9,18,2,1,5,3,17,19
Arizona State,10,Maurice O'Field,10,47,4,7,0.571,4,6,0.667,0,1,0,0,0,,3,3,6,4,1,0,1,4,8
Arizona State,11,Austin Witherill,16,25,0,4,0,0,0,,0,4,0,2,2,1,0,2,2,1,0,0,0,0,2
Arizona State,12,Grant Fogerty,2,2,0,0,,0,0,,0,0,,0,0,,0,0,0,0,0,0,0,0,0
Arizona State,13,Romaine Jackson,4,5,0,0,,0,0,,0,0,,0,0,,1,0,1,0,0,0,2,0,0
Arizona State,14,Chris Odionu,2,2,0,0,,0,0,,0,0,,0,0,,0,0,0,0,0,0,0,1,0
Stanford,1,Reid Travis,27,813,176,304,0.579,176,303,0.581,0,1,0,118,181,0.652,93,146,239,14,14,5,56,64,470
Stanford,2,Dorian Pickens,31,927,123,287,0.429,56,118,0.475,67,169,0.396,79,107,0.738,23,86,109,38,32,3,43,57,392
Stanford,3,Michael Humphrey,30,721,113,248,0.456,107,221,0.484,6,27,0.222,51,70,0.729,67,120,187,28,27,18,48,104,283
Stanford,4,Marcus Allen,29,762,91,210,0.433,81,160,0.506,10,50,0.2,44,70,0.629,12,55,67,52,36,2,47,57,236
Stanford,5,Robert Cartwright,31,765,74,209,0.354,46,105,0.438,28,104,0.269,32,42,0.762,5,51,56,110,30,1,48,50,208
Stanford,6,Marcus Sheffield,31,587,66,182,0.363,43,111,0.387,23,71,0.324,52,64,0.813,1,47,48,48,26,2,38,39,207
Stanford,7,Grant Verhoeven,30,379,42,81,0.519,37,68,0.544,5,13,0.385,24,33,0.727,33,40,73,5,11,7,13,69,113
Stanford,8,Josh Sharma,31,416,41,105,0.39,35,83,0.422,6,22,0.273,13,29,0.448,25,64,89,4,8,34,22,80,101
Stanford,9,Christian Sanders,31,532,29,71,0.408,18,48,0.375,11,23,0.478,25,38,0.658,3,57,60,103,14,3,55,54,94
Stanford,10,Malcolm Allen,13,113,9,21,0.429,8,15,0.533,1,6,0.167,6,8,0.75,1,9,10,10,6,0,4,8,25
Stanford,11,Cameron Walker,14,99,4,11,0.364,4,10,0.4,0,1,0,11,16,0.688,7,18,25,3,3,1,8,14,19
Stanford,12,Trevor Stanback,16,91,3,17,0.176,3,17,0.176,0,0,,4,14,0.286,7,4,11,6,3,3,5,8,10
Stanford,13,Rodney Herenton,5,5,1,4,0.25,1,3,0.333,0,1,0,0,2,0,0,0,0,0,0,0,2,0,2
Stanford,14,Blake Pagon,5,10,0,2,0,0,1,0,0,1,0,2,2,1,1,1,2,0,1,0,1,0,2
Stanford,15,Josh Hanson,4,5,0,1,0,0,0,,0,1,0,0,0,,0,0,0,0,0,0,0,0,0
Washington State,1,Josh Hawkinson,31,1097,173,326,0.531,145,257,0.564,28,69,0.406,105,126,0.833,56,259,315,79,19,25,53,73,479
Washington State,2,Ike Iroegbu,31,1061,134,297,0.451,101,209,0.483,33,88,0.375,89,131,0.679,26,103,129,112,22,4,65,63,390
Washington State,3,Charles Callison,31,844,114,250,0.456,72,151,0.477,42,99,0.424,32,38,0.842,5,48,53,67,39,11,49,73,302
Washington State,4,Malachi Flynn,31,1027,104,263,0.395,46,113,0.407,58,150,0.387,36,49,0.735,8,83,91,91,21,1,65,59,302
Washington State,5,Conor Clifford,31,610,126,214,0.589,126,213,0.592,0,1,0,40,47,0.851,18,67,85,27,1,20,53,85,292
Washington State,6,Robert Franks,31,509,73,166,0.44,54,105,0.514,19,61,0.311,30,41,0.732,28,73,101,24,4,18,41,59,195
Washington State,7,Viont'e Daniels,27,463,28,70,0.4,11,23,0.478,17,47,0.362,6,12,0.5,8,24,32,35,11,2,11,33,79
Washington State,8,Derrien King,9,221,17,60,0.283,12,35,0.343,5,25,0.2,20,26,0.769,5,34,39,7,3,2,24,19,59
Washington State,9,Jeff Pollard,24,205,17,36,0.472,17,36,0.472,0,0,,10,16,0.625,11,32,43,4,5,2,8,24,44
Washington State,10,KJ Langston,20,159,13,47,0.277,7,21,0.333,6,26,0.231,0,1,0,2,9,11,6,5,0,7,10,32
Washington State,11,Steven Shpreyregin,7,29,2,10,0.2,1,2,0.5,1,8,0.125,0,0,,0,3,3,1,0,0,0,4,5
Washington,1,Markelle Fultz,25,892,209,439,0.476,157,313,0.502,52,126,0.413,109,168,0.649,33,110,143,148,39,30,80,63,579
Washington,2,David Crisp,31,1021,151,367,0.411,74,157,0.471,77,210,0.367,48,70,0.686,25,73,98,97,17,4,76,73,427
Washington,3,Noah Dickerson,31,843,146,267,0.547,145,258,0.562,1,9,0.111,96,142,0.676,83,170,253,24,15,14,45,98,389
Washington,4,Matisse Thybulle,31,928,117,261,0.448,64,130,0.492,53,131,0.405,37,44,0.841,25,71,96,55,65,22,63,90,324
Washington,5,Carlos Johnson,31,555,71,175,0.406,64,143,0.448,7,32,0.219,33,54,0.611,45,47,92,21,9,7,38,72,182
Washington,6,Dominic Green,30,648,57,180,0.317,29,80,0.363,28,100,0.28,22,29,0.759,21,42,63,21,12,12,29,56,164
Washington,7,Malik Dime,20,429,42,82,0.512,42,82,0.512,0,0,,26,43,0.605,44,65,109,16,9,49,22,57,110
Washington,8,Sam Timmins,31,450,45,92,0.489,43,85,0.506,2,7,0.286,6,16,0.375,40,79,119,9,11,19,37,50,98
Washington,9,Matthew Atewe,19,165,16,31,0.516,16,31,0.516,0,0,,10,21,0.476,19,24,43,1,3,13,13,26,42
Washington,10,Dan Kingma,19,119,5,17,0.294,1,4,0.25,4,13,0.308,2,6,0.333,1,9,10,9,3,0,8,16,16
Washington,11,Greg Bowman,11,21,5,9,0.556,5,9,0.556,0,0,,2,6,0.333,5,6,11,1,1,0,1,1,12
Washington,12,Bitumba Baruti,17,71,4,14,0.286,4,8,0.5,0,6,0,3,3,1,4,3,7,2,2,0,5,12,11
Washington,13,Devenir Duruisseau,19,71,4,10,0.4,4,10,0.4,0,0,,0,0,,3,14,17,2,1,1,5,14,8
Washington,14,Quin Barnard,9,13,2,5,0.4,0,0,,2,5,0.4,0,0,,1,0,1,2,0,0,1,0,6
Oregon State,1,Drew Eubanks,32,1027,182,310,0.587,182,310,0.587,0,0,,99,139,0.712,81,185,266,39,20,69,96,92,463
Oregon State,2,Stephen Thompson Jr.,26,940,148,373,0.397,91,206,0.442,57,167,0.341,71,112,0.634,30,81,111,79,37,4,73,58,424
Oregon State,3,Jaquori McLaughlin,32,1082,113,295,0.383,55,137,0.401,58,158,0.367,52,70,0.743,6,63,69,104,26,9,69,90,336
Oregon State,4,Kendal Manuel,32,923,86,229,0.376,34,94,0.362,52,135,0.385,24,34,0.706,13,64,77,52,29,2,57,66,248
Oregon State,5,Gligorije Rakocevic,32,598,54,119,0.454,46,100,0.46,8,19,0.421,30,57,0.526,47,72,119,6,7,9,39,77,146
Oregon State,6,Tres Tinkle,6,209,36,81,0.444,32,56,0.571,4,25,0.16,45,58,0.776,4,46,50,14,13,5,19,12,121
Oregon State,7,Ronnie Stacy,31,402,26,68,0.382,24,58,0.414,2,10,0.2,15,26,0.577,8,41,49,28,15,1,40,44,69
Oregon State,8,Ben Kone,23,308,22,75,0.293,15,54,0.278,7,21,0.333,15,24,0.625,16,46,62,5,6,3,24,46,66
Oregon State,9,Matt Dahlen,30,313,17,34,0.5,17,33,0.515,0,1,0,12,24,0.5,18,40,58,18,8,4,20,64,46
Oregon State,10,Daine Muller,21,207,13,28,0.464,0,0,,13,28,0.464,3,4,0.75,1,17,18,18,3,0,9,19,42
Oregon State,11,Cheikh N'diaye,9,97,12,23,0.522,12,23,0.522,0,0,,8,13,0.615,8,12,20,1,0,7,10,13,32
Oregon State,12,Tanner Sanders,29,249,7,32,0.219,5,10,0.5,2,22,0.091,0,2,0,6,25,31,12,10,4,10,19,16
Oregon State,13,Keondre Dew,6,70,5,19,0.263,5,19,0.263,0,0,,2,6,0.333,6,13,19,4,3,1,12,11,12
Villanova,1,Josh Hart,36,1193,236,463,0.51,162,280,0.579,74,183,0.404,127,170,0.747,51,179,230,106,55,10,71,81,673
Villanova,2,Jalen Brunson,36,1118,183,338,0.541,141,227,0.621,42,111,0.378,120,137,0.876,17,76,93,148,32,0,74,59,528
Villanova,3,Kris Jenkins,36,1118,142,370,0.384,56,131,0.427,86,239,0.36,100,116,0.862,13,136,149,73,40,10,52,70,470
Villanova,4,Mikal Bridges,36,1073,128,233,0.549,84,121,0.694,44,112,0.393,51,56,0.911,41,124,165,71,61,32,46,82,351
Villanova,5,Donte DiVincenzo,36,919,109,234,0.466,67,119,0.563,42,115,0.365,58,83,0.699,37,100,137,61,33,10,51,58,318
Villanova,6,Eric Paschall,36,781,100,195,0.513,81,127,0.638,19,68,0.279,41,59,0.695,49,86,135,22,19,18,43,90,260
Villanova,7,Darryl Reynolds,31,738,55,80,0.688,55,80,0.688,0,0,,29,43,0.674,63,104,167,18,16,29,35,53,139
Villanova,8,Dylan Painter,22,127,6,14,0.429,6,11,0.545,0,3,0,8,12,0.667,7,24,31,0,1,0,5,13,20
Villanova,9,Phil Booth,3,72,5,19,0.263,2,9,0.222,3,10,0.3,4,4,1,1,4,5,6,1,0,6,3,17
Villanova,10,Tim Delaney,7,26,1,2,0.5,0,0,,1,2,0.5,0,0,,0,2,2,0,0,0,2,4,3
Villanova,11,Denny Grace,7,10,0,0,,0,0,,0,0,,0,0,,0,2,2,0,0,0,1,2,0
Villanova,12,Matt Kennedy,7,14,0,0,,0,0,,0,0,,0,0,,1,0,1,0,0,0,0,0,0
Villanova,13,Tom Leibig,7,11,0,0,,0,0,,0,0,,0,1,0,0,3,3,0,1,0,0,0,0
Butler,1,Kelan Martin,34,977,180,421,0.428,116,237,0.489,64,184,0.348,120,153,0.784,34,162,196,40,23,14,66,74,544
Butler,2,Andrew Chrabascz,34,1112,129,284,0.454,104,215,0.484,25,69,0.362,105,138,0.761,52,103,155,107,24,9,57,83,388
Butler,3,Kamar Baldwin,34,916,138,279,0.495,103,185,0.557,35,94,0.372,34,45,0.756,15,111,126,50,59,18,51,76,345
Butler,4,Avery Woodson,34,762,103,238,0.433,28,60,0.467,75,178,0.421,20,26,0.769,8,79,87,23,10,9,11,59,301
Butler,5,Tyler Wideman,34,781,96,156,0.615,96,154,0.623,0,2,0,53,81,0.654,70,100,170,15,20,26,38,102,245
Butler,6,Kethan Savage,30,613,77,174,0.443,63,126,0.5,14,48,0.292,71,95,0.747,5,75,80,46,27,6,34,59,239
Butler,7,Tyler Lewis,34,743,71,137,0.518,49,81,0.605,22,56,0.393,59,80,0.738,9,40,49,137,22,1,33,58,223
Butler,8,Nate Fowler,34,405,66,99,0.667,56,78,0.718,10,21,0.476,37,47,0.787,38,32,70,14,7,4,21,57,179
Butler,9,Sean McDermott,30,322,22,53,0.415,7,11,0.636,15,42,0.357,10,15,0.667,12,31,43,9,6,6,10,42,69
Butler,10,Henry Baddley,24,117,11,25,0.44,11,17,0.647,0,8,0,4,9,0.444,5,14,19,5,7,2,6,16,26
Butler,11,Joey Brunk,7,49,7,13,0.538,7,11,0.636,0,2,0,8,12,0.667,0,7,7,1,1,1,3,8,22
Butler,12,Trey Pettus,7,24,4,10,0.4,4,6,0.667,0,4,0,1,2,0.5,0,2,2,3,0,0,2,3,9
Butler,13,Steven Bennett,7,29,2,9,0.222,1,3,0.333,1,6,0.167,0,1,0,0,3,3,3,0,0,2,3,5
Creighton,1,Marcus Foster,35,1081,245,531,0.461,172,318,0.541,73,213,0.343,75,107,0.701,9,92,101,85,22,2,78,68,638
Creighton,2,Justin Patton,35,885,200,296,0.676,192,281,0.683,8,15,0.533,45,87,0.517,59,158,217,41,31,50,60,96,453
Creighton,3,Khyri Thomas,35,1093,162,324,0.5,116,206,0.563,46,118,0.39,59,77,0.766,53,149,202,116,51,15,69,55,429
Creighton,4,Cole Huff,35,805,106,231,0.459,44,97,0.454,62,134,0.463,47,56,0.839,19,118,137,22,14,4,22,61,321
Creighton,5,Maurice Watson Jr.,19,568,97,191,0.508,82,159,0.516,15,32,0.469,36,52,0.692,6,44,50,162,28,0,71,36,245
Creighton,6,Toby Hegner,35,585,58,123,0.472,26,52,0.5,32,71,0.451,27,42,0.643,26,92,118,16,13,9,14,66,175
Creighton,7,Isaiah Zierden,35,699,47,112,0.42,6,13,0.462,41,99,0.414,37,40,0.925,4,65,69,29,15,2,22,48,172
Creighton,8,Zach Hanson,20,204,48,75,0.64,48,75,0.64,0,0,,12,27,0.444,16,29,45,5,6,1,11,26,108
Creighton,9,Davion Mintz,29,354,30,78,0.385,21,53,0.396,9,25,0.36,26,33,0.788,1,31,32,52,15,4,34,35,95
Creighton,10,Martin Krampelj,28,172,31,59,0.525,29,51,0.569,2,8,0.25,16,29,0.552,28,35,63,6,1,10,11,27,80
Creighton,11,Ronnie Harrell,26,189,23,47,0.489,20,35,0.571,3,12,0.25,18,28,0.643,16,33,49,19,6,3,9,14,67
Creighton,12,Tyler Clement,28,264,17,35,0.486,10,16,0.625,7,19,0.368,4,7,0.571,1,28,29,38,8,1,25,36,45
Creighton,13,Kobe Paras,15,70,8,23,0.348,6,13,0.462,2,10,0.2,2,7,0.286,4,10,14,3,2,1,4,11,20
Creighton,14,Jordan Scurry,11,31,6,12,0.5,2,2,1,4,10,0.4,0,0,,0,4,4,4,1,0,0,3,16
Seton Hall,1,Khadeen Carrington,33,1099,189,446,0.424,126,281,0.448,63,165,0.382,122,167,0.731,19,83,102,97,38,10,75,62,563
Seton Hall,2,Desi Rodriguez,33,1054,192,437,0.439,142,296,0.48,50,141,0.355,85,133,0.639,43,128,171,58,27,14,69,83,519
Seton Hall,3,Angel Delgado,33,1090,197,363,0.543,197,363,0.543,0,0,,109,196,0.556,166,264,430,74,21,10,99,83,503
Seton Hall,4,Myles Powell,33,785,118,301,0.392,50,96,0.521,68,205,0.332,49,60,0.817,19,55,74,29,30,6,32,67,353
Seton Hall,5,Madison Jones,33,973,69,168,0.411,55,123,0.447,14,45,0.311,41,60,0.683,15,67,82,104,58,4,65,91,193
Seton Hall,6,Michael Nzei,33,595,54,84,0.643,54,83,0.651,0,1,0,35,59,0.593,62,65,127,7,12,18,29,81,143
Seton Hall,7,Ismael Sanogo,28,624,32,73,0.438,31,70,0.443,1,3,0.333,19,38,0.5,47,109,156,21,25,18,32,64,84
Seton Hall,8,Eron Gordon,18,74,10,26,0.385,9,15,0.6,1,11,0.091,2,2,1,5,10,15,6,3,0,5,13,23
Seton Hall,9,Veer Singh,9,84,3,15,0.2,1,3,0.333,2,12,0.167,4,5,0.8,2,12,14,1,0,1,5,10,12
Seton Hall,10,Rashed Anthony,29,128,2,6,0.333,2,6,0.333,0,0,,3,3,1,9,9,18,0,1,1,4,35,7
Seton Hall,11,Jevon Thomas,10,92,2,11,0.182,1,8,0.125,1,3,0.333,2,9,0.222,1,9,10,8,11,0,13,17,7
Seton Hall,12,Dalton Soffer,10,30,2,12,0.167,0,0,,2,12,0.167,0,0,,0,2,2,0,1,0,1,2,6
Seton Hall,13,Myles Carter,5,33,2,7,0.286,2,7,0.286,0,0,,0,1,0,2,5,7,0,1,0,3,5,4
Seton Hall,14,Manny Anderson,4,5,0,0,,0,0,,0,0,,0,0,,0,0,0,0,0,0,0,0,0
Seton Hall,15,MIchael Dowdy,6,9,0,0,,0,0,,0,0,,0,0,,0,1,1,0,0,0,0,0,0
Providence,1,Rodney Bullock,33,1082,177,406,0.436,131,261,0.502,46,145,0.317,119,159,0.748,45,166,211,47,38,27,81,76,519
Providence,2,Emmitt Holt,32,879,149,285,0.523,128,224,0.571,21,61,0.344,82,121,0.678,55,117,172,32,22,25,45,101,401
Providence,3,Kyron Cartwright,33,1091,132,314,0.42,101,234,0.432,31,80,0.388,80,112,0.714,17,100,117,222,36,1,96,67,375
Providence,4,Jalen Lindsey,32,1026,106,232,0.457,32,71,0.451,74,161,0.46,57,77,0.74,38,100,138,22,28,8,23,69,343
Providence,5,Alpha Diallo,33,705,59,145,0.407,50,108,0.463,9,37,0.243,62,84,0.738,32,73,105,39,29,5,41,78,189
Providence,6,Isaiah Jackson,33,552,64,133,0.481,45,86,0.523,19,47,0.404,38,51,0.745,12,68,80,41,18,9,36,47,185
Providence,7,Kalif Young,33,432,44,85,0.518,44,84,0.524,0,1,0,17,46,0.37,46,60,106,13,12,17,33,56,105
Providence,8,Ryan Fazekas,30,353,31,80,0.388,9,21,0.429,22,59,0.373,6,9,0.667,0,33,33,9,11,2,5,28,90
Providence,9,Maliek White,33,379,32,84,0.381,20,47,0.426,12,37,0.324,6,11,0.545,5,28,33,44,20,2,32,35,82
Providence,10,Drew Edwards,8,86,8,19,0.421,5,13,0.385,3,6,0.5,5,10,0.5,0,5,5,2,4,1,5,10,24
Providence,11,Ricky Council II,5,20,1,6,0.167,0,0,,1,6,0.167,0,0,,0,3,3,0,0,0,3,1,3
Providence,12,Casey Woodring,4,7,1,6,0.167,0,1,0,1,5,0.2,0,0,,1,1,2,0,0,0,0,0,3
Providence,13,Tom Planek,7,13,0,0,,0,0,,0,0,,0,3,0,3,3,6,0,0,1,2,1,0
Marquette,1,Markus Howard,31,22,4.4,8.7,0.506,1.7,3.8,0.454,2.6,4.8,0.547,1.8,2,0.889,2.2,2.3,0.8,0.1,2,2.5,13.2,,
Marquette,2,JaJuan Johnson,31,26,4.4,9.3,0.476,3.4,6.6,0.515,1,2.7,0.381,2.1,2.6,0.793,4.1,2.7,1.9,0.5,2.3,1.6,12,,
Marquette,3,Andrew Rowsey,32,20.8,3.3,7.2,0.461,1.1,2.2,0.493,2.2,5,0.447,2.8,3,0.926,1.8,2.3,0.7,0,1.3,2.1,11.6,,
Marquette,4,Luke Fischer,32,24,4.7,7.3,0.647,4.7,7.3,0.647,0,0,,1.6,2.7,0.588,5.9,1.2,0.6,1.7,1.2,3.4,10.9,,
Marquette,5,Katin Reinhardt,29,25.8,3.6,8.9,0.403,1.6,3.7,0.443,2,5.2,0.375,1.7,1.9,0.889,2.7,2.1,0.6,0.1,1.3,1.4,10.8,,
Marquette,6,Sam Hauser,32,26.5,3,6.4,0.473,1.1,2.1,0.515,2,4.3,0.453,0.8,0.9,0.828,5,1.3,0.8,0.6,0.7,2.5,8.8,,
Marquette,7,Haanif Cheatham,32,25.4,2.9,6.3,0.458,2.5,5.1,0.491,0.4,1.3,0.325,2.5,3.2,0.767,3.8,2.2,0.7,0.1,1.6,1.5,8.7,,
Marquette,8,Duane Wilson,30,16.4,1.8,4.3,0.422,1.3,2.7,0.5,0.5,1.6,0.292,0.7,1.1,0.688,1.8,1.6,1,0.1,0.8,2,4.8,,
Marquette,9,Traci Carter,8,16.3,1.6,2.9,0.565,1.3,2,0.625,0.4,0.9,0.429,0.6,1,0.625,2.1,3.6,0.5,0,1.4,1.9,4.3,,
Marquette,10,Matt Heldt,32,13.1,0.9,1.3,0.7,0.9,1.3,0.7,0,0,,0.6,1,0.563,2.9,0.2,0.2,0.4,0.3,2.1,2.3,,
Marquette,11,Cam Marotta,9,2.1,0.1,0.7,0.167,0,0.3,0,0.1,0.3,0.333,0.2,0.2,1,0.2,0.2,0,0,0.3,0.2,0.6,,
Marquette,12,Sandy Cohen,3,6.3,0,1.3,0,0,1.3,0,0,0,,0,0,,1,0.3,0,0.7,1.3,0.3,0,,
Marquette,13,Deon Franklin,8,2,0,0.3,0,0,0.1,0,0,0.1,0,0,0,,0.4,0,0.1,0.1,0.1,0.5,0,,
Xavier,1,Trevon Bluiett,36,1262,212,483,0.439,121,239,0.506,91,244,0.373,149,198,0.753,26,178,204,74,32,4,78,86,664
Xavier,2,J.P. Macura,38,1272,179,421,0.425,115,231,0.498,64,190,0.337,124,157,0.79,50,117,167,110,54,8,77,90,546
Xavier,3,Edmond Sumner,22,697,101,211,0.479,89,167,0.533,12,44,0.273,101,137,0.737,11,81,92,105,27,16,58,51,315
Xavier,4,Rashid Gaston,38,689,115,195,0.59,115,195,0.59,0,0,,51,92,0.554,93,131,224,23,6,18,41,87,281
Xavier,5,Malcolm Bernard,38,1065,84,201,0.418,38,84,0.452,46,117,0.393,35,60,0.583,47,107,154,58,37,12,56,104,249
Xavier,6,Sean O'Mara,38,523,88,146,0.603,88,146,0.603,0,0,,54,79,0.684,51,65,116,23,12,13,32,66,230
Xavier,7,Quentin Goodin,38,916,70,200,0.35,57,149,0.383,13,51,0.255,42,73,0.575,6,71,77,131,35,7,74,80,195
Xavier,8,Kaiser Gates,33,692,63,162,0.389,23,44,0.523,40,118,0.339,26,36,0.722,37,96,133,22,15,5,22,60,192
Xavier,9,Tyrique Jones,37,406,68,113,0.602,68,113,0.602,0,0,,20,41,0.488,58,56,114,11,9,16,27,74,156
Xavier,10,Leighton Schrand,9,8,0,1,0,0,1,0,0,0,,3,4,0.75,0,0,0,0,0,0,1,1,3
Xavier,11,Tim Stainbrook,13,37,1,5,0.2,0,0,,1,5,0.2,0,0,,0,3,3,2,0,1,0,4,3
Xavier,12,Myles Davis,4,34,0,8,0,0,2,0,0,6,0,2,4,0.5,0,2,2,0,1,0,2,5,2
Xavier,13,Cullen Barr,9,8,0,2,0,0,1,0,0,1,0,0,0,,0,0,0,0,0,0,0,0,0
Xavier,14,Alex Bergen,10,8,0,0,,0,0,,0,0,,0,0,,1,1,2,0,0,0,0,0,0
Xavier,15,Conor Peterson,9,8,0,0,,0,0,,0,0,,0,0,,0,2,2,0,0,0,0,0,0
St. John's,1,Shamorie Ponds,33,1109,191,435,0.439,116,235,0.494,75,200,0.375,116,141,0.823,38,108,146,102,68,8,62,58,573
St. John's,2,Marcus LoVett,30,948,166,358,0.464,116,227,0.511,50,131,0.382,94,117,0.803,18,70,88,113,40,1,79,61,476
St. John's,3,Bashir Ahmed,33,881,142,360,0.394,90,213,0.423,52,147,0.354,106,156,0.679,59,121,180,40,18,19,75,83,442
St. John's,4,Federico Mussini,30,576,77,188,0.41,21,57,0.368,56,131,0.427,35,41,0.854,6,46,52,26,17,0,29,37,245
St. John's,5,Malik Ellison,33,818,83,198,0.419,53,110,0.482,30,88,0.341,47,79,0.595,22,86,108,84,31,8,59,95,243
St. John's,6,Tariq Owens,32,601,65,129,0.504,65,127,0.512,0,2,0,36,48,0.75,59,105,164,15,19,69,29,103,166
St. John's,7,Kassoum Yakwe,33,675,51,120,0.425,51,120,0.425,0,0,,35,59,0.593,35,72,107,25,8,64,29,94,137
St. John's,8,Darien Williams,24,285,34,63,0.54,34,62,0.548,0,1,0,24,33,0.727,19,43,62,4,10,11,15,52,92
St. John's,9,Yankuba Sima,10,178,21,47,0.447,21,47,0.447,0,0,,18,25,0.72,13,22,35,6,4,5,10,24,60
St. John's,10,Amar Alibegovic,26,267,19,46,0.413,12,21,0.571,7,25,0.28,10,17,0.588,9,34,43,17,5,10,14,47,55
St. John's,11,Richard Freudenberg,26,242,12,48,0.25,5,13,0.385,7,35,0.2,3,4,0.75,6,29,35,12,1,2,17,30,34
St. John's,12,Elijah Holifield,8,13,4,6,0.667,3,3,1,1,3,0.333,0,2,0,0,1,1,2,3,0,2,4,9
St. John's,13,Brandon Lawrence,3,2,1,1,1,1,1,1,0,0,,0,0,,0,0,0,0,0,0,0,0,2
St. John's,14,Marvin Clark,1,0,0,0,,0,0,,0,0,,0,0,,0,0,0,0,0,0,0,0,0
St. John's,15,Justin Cole,3,5,0,1,0,0,1,0,0,0,,0,0,,0,1,1,0,0,0,0,0,0
St. John's,16,Justin Simon,1,0,0,0,,0,0,,0,0,,0,0,,0,0,0,0,0,0,0,0,0
Georgetown,1,Rodney Pryor,32,1044,212,440,0.482,128,237,0.54,84,203,0.414,69,94,0.734,34,127,161,41,25,22,55,73,577
Georgetown,2,L.J. Peak,32,1051,167,348,0.48,134,247,0.543,33,101,0.327,152,191,0.796,33,89,122,111,34,12,86,88,519
Georgetown,3,Jessie Govan,32,671,128,250,0.512,114,215,0.53,14,35,0.4,54,81,0.667,38,121,159,45,16,32,55,89,324
Georgetown,4,Marcus Derrickson,28,665,76,176,0.432,44,83,0.53,32,93,0.344,48,58,0.828,34,89,123,40,12,18,37,84,232
Georgetown,5,Akoy Agau,32,479,42,84,0.5,39,69,0.565,3,15,0.2,57,67,0.851,34,102,136,28,7,28,50,71,144
Georgetown,6,Jagan Mosely,31,621,36,97,0.371,27,60,0.45,9,37,0.243,50,65,0.769,9,60,69,79,23,5,42,67,131
Georgetown,7,Jonathan Mulmore,32,646,30,84,0.357,20,55,0.364,10,29,0.345,45,60,0.75,6,37,43,60,17,4,37,74,115
Georgetown,8,Bradley Hayes,25,340,47,88,0.534,47,88,0.534,0,0,,12,32,0.375,32,69,101,21,8,21,31,46,106
Georgetown,9,Tre Campbell,21,294,24,62,0.387,12,27,0.444,12,35,0.343,13,21,0.619,3,23,26,28,12,0,19,17,73
Georgetown,10,Kaleb Johnson,31,333,23,52,0.442,20,40,0.5,3,12,0.25,23,44,0.523,22,38,60,13,11,3,13,41,72
Georgetown,11,Isaac Copeland,7,137,11,40,0.275,11,30,0.367,0,10,0,16,19,0.842,8,15,23,6,6,0,7,12,38
Georgetown,12,Reggie Cameron,17,138,9,23,0.391,3,5,0.6,6,18,0.333,5,10,0.5,2,14,16,7,3,1,8,6,29
Georgetown,13,Trey Mourning,10,18,3,6,0.5,3,6,0.5,0,0,,2,2,1,1,4,5,0,0,1,0,4,8
Georgetown,14,Ra'Mond Hines,5,7,0,1,0,0,0,,0,1,0,1,2,0.5,0,0,0,1,0,0,1,0,1
Georgetown,15,George Muresan,5,6,0,1,0,0,0,,0,1,0,0,0,,0,0,0,0,1,0,0,0,0
DePaul,1,Eli Cain,32,1059,169,425,0.398,118,277,0.426,51,148,0.345,111,154,0.721,32,112,144,85,33,12,76,85,500
DePaul,2,Billy Garrett,32,938,140,361,0.388,99,248,0.399,41,113,0.363,157,178,0.882,12,80,92,107,37,5,105,81,478
DePaul,3,Tre'Darius McCallum,32,993,124,280,0.443,102,202,0.505,22,78,0.282,41,55,0.745,49,168,217,43,49,26,52,92,311
DePaul,4,Brandon Cyrus,32,840,72,190,0.379,62,151,0.411,10,39,0.256,47,67,0.701,52,81,133,29,28,7,46,76,201
DePaul,5,Chris Harrison-Docks,26,508,55,152,0.362,15,37,0.405,40,115,0.348,15,16,0.938,6,14,20,21,15,0,27,40,165
DePaul,6,Joe Hanel,32,823,61,94,0.649,61,94,0.649,0,0,,26,50,0.52,67,87,154,24,14,13,40,110,148
DePaul,7,Devin Gage,29,346,45,95,0.474,40,74,0.541,5,21,0.238,21,29,0.724,6,19,25,27,22,7,30,37,116
DePaul,8,Darrick Wood,19,193,32,75,0.427,24,51,0.471,8,24,0.333,12,23,0.522,8,18,26,13,4,1,15,23,84
DePaul,9,R.J. Curington,19,180,26,54,0.481,21,32,0.656,5,22,0.227,17,21,0.81,17,20,37,11,7,3,15,19,74
DePaul,10,Levi Cook,25,273,29,48,0.604,29,48,0.604,0,0,,8,13,0.615,26,32,58,3,1,10,21,45,66
DePaul,11,Al Eichelberger,26,212,16,21,0.762,16,21,0.762,0,0,,13,32,0.406,15,17,32,1,2,8,10,26,45
DePaul,12,Erten Gazi,13,55,6,9,0.667,4,5,0.8,2,4,0.5,4,4,1,3,8,11,2,1,0,3,1,18
DePaul,13,David Leitao III,2,5,0,0,,0,0,,0,0,,0,0,,0,1,1,0,0,0,0,0,0
Purdue,1,Caleb Swanigan,35,1139,222,421,0.527,184,336,0.548,38,85,0.447,164,210,0.781,96,340,436,106,15,28,118,97,646
Purdue,2,Isaac Haas,35,682,159,271,0.587,159,271,0.587,0,0,,123,173,0.711,62,112,174,20,9,27,78,73,441
Purdue,3,Vince Edwards,35,1001,160,329,0.486,113,218,0.518,47,111,0.423,73,89,0.82,66,107,173,112,19,18,58,64,440
Purdue,4,Carsen Edwards,35,813,128,335,0.382,79,191,0.414,49,144,0.34,55,76,0.724,14,77,91,62,37,3,64,68,360
Purdue,5,Dakota Mathias,35,1111,118,251,0.47,46,92,0.5,72,159,0.453,32,39,0.821,11,126,137,133,30,4,52,75,340
Purdue,6,P.J. Thompson,35,1000,87,191,0.455,34,59,0.576,53,132,0.402,31,44,0.705,24,49,73,102,36,1,26,69,258
Purdue,7,Ryan Cline,31,663,57,134,0.425,12,25,0.48,45,109,0.413,9,11,0.818,5,57,62,50,11,3,22,43,168
Purdue,8,Basil Smotherman,18,217,30,54,0.556,26,41,0.634,4,13,0.308,6,11,0.545,7,23,30,15,9,1,12,30,70
Purdue,9,Spike Albrecht,28,350,11,41,0.268,5,15,0.333,6,26,0.231,18,19,0.947,11,30,41,36,11,1,9,25,46
Purdue,10,Grady Eifert,16,46,6,7,0.857,6,7,0.857,0,0,,3,5,0.6,3,5,8,0,1,1,0,3,15
Purdue,11,Jon McKeeman,15,28,2,5,0.4,1,3,0.333,1,2,0.5,0,0,,1,0,1,0,2,0,2,2,5
Purdue,12,Tommy Luce,15,25,0,5,0,0,4,0,0,1,0,1,3,0.333,0,0,0,4,1,0,6,3,1
Wisconsin,1,Bronson Koenig,36,1129,181,431,0.42,78,170,0.459,103,261,0.395,57,63,0.905,6,70,76,73,23,12,51,61,522
Wisconsin,2,Ethan Happ,37,1033,218,371,0.588,218,371,0.588,0,0,,81,162,0.5,117,215,332,105,67,43,80,102,517
Wisconsin,3,Nigel Hayes,37,1190,180,394,0.457,158,324,0.488,22,70,0.314,135,230,0.587,82,163,245,100,28,14,63,67,517
Wisconsin,4,Zak Showalter,37,1088,107,214,0.5,58,91,0.637,49,123,0.398,44,53,0.83,29,79,108,65,56,11,41,99,307
Wisconsin,5,Vitto Brown,37,772,92,232,0.397,48,94,0.511,44,138,0.319,25,33,0.758,46,95,141,37,19,16,53,76,253
Wisconsin,6,D'Mitrik Trice,37,674,70,184,0.38,32,93,0.344,38,91,0.418,30,38,0.789,7,62,69,63,20,3,37,51,208
Wisconsin,7,Khalil Iverson,35,531,50,94,0.532,46,81,0.568,4,13,0.308,32,57,0.561,45,71,116,22,18,20,33,37,136
Wisconsin,8,Charles Thomas IV,28,177,21,54,0.389,19,48,0.396,2,6,0.333,18,20,0.9,14,22,36,6,0,4,17,40,62
Wisconsin,9,Jordan Hill,35,356,19,54,0.352,10,19,0.526,9,35,0.257,6,9,0.667,7,31,38,16,6,1,9,26,53
Wisconsin,10,Brevin Pritzl,24,207,13,38,0.342,8,17,0.471,5,21,0.238,14,19,0.737,14,12,26,2,7,0,5,18,45
Wisconsin,11,Alex Illikainen,27,224,12,37,0.324,8,21,0.381,4,16,0.25,6,12,0.5,16,24,40,9,3,3,5,19,34
Wisconsin,12,Andy Van Vliet,13,48,6,17,0.353,3,9,0.333,3,8,0.375,3,4,0.75,5,15,20,2,0,2,2,3,18
Wisconsin,13,Aaron Moesch,17,40,1,4,0.25,1,4,0.25,0,0,,1,2,0.5,5,2,7,2,2,0,0,1,3
Wisconsin,14,T.J. Schlundt,12,20,1,6,0.167,1,2,0.5,0,4,0,1,1,1,1,1,2,0,0,1,0,1,3
Wisconsin,15,Matt Ferris,9,11,0,5,0,0,3,0,0,2,0,0,0,,3,2,5,2,1,0,0,1,0
Maryland,1,Melo Trimble,33,1059,180,413,0.436,122,230,0.53,58,183,0.317,138,175,0.789,9,110,119,121,36,5,100,59,556
Maryland,2,Justin Jackson,33,919,117,267,0.438,71,162,0.438,46,105,0.438,67,96,0.698,58,141,199,31,29,26,54,72,347
Maryland,3,Anthony Cowan,33,957,97,229,0.424,71,148,0.48,26,81,0.321,120,156,0.769,29,100,129,123,40,5,76,67,340
Maryland,4,Kevin Huerter,33,971,111,264,0.42,46,89,0.517,65,175,0.371,20,28,0.714,22,141,163,88,32,23,46,60,307
Maryland,5,Jaylen Brantley,33,555,55,144,0.382,23,61,0.377,32,83,0.386,21,34,0.618,9,56,65,32,17,0,21,44,163
Maryland,6,Damonte Dodd,26,507,61,105,0.581,61,105,0.581,0,0,,39,74,0.527,70,44,114,11,5,52,36,89,161
Maryland,7,Ivan Bender,32,456,63,95,0.663,63,95,0.663,0,0,,28,45,0.622,32,70,102,28,5,12,29,75,154
Maryland,8,Michal Cekovsky,17,224,55,82,0.671,55,82,0.671,0,0,,19,37,0.514,21,27,48,8,2,20,16,43,129
Maryland,9,L.G. Gill,33,419,37,82,0.451,34,72,0.472,3,10,0.3,38,59,0.644,26,42,68,9,5,5,11,52,115
Maryland,10,Jared Nickens,33,337,32,98,0.327,5,19,0.263,27,79,0.342,10,12,0.833,6,23,29,8,4,2,13,27,101
Maryland,11,Dion Wiley,20,205,19,59,0.322,4,19,0.211,15,40,0.375,10,14,0.714,10,19,29,11,4,4,12,21,63
Maryland,12,Travis Valmon,5,8,0,1,0,0,1,0,0,0,,2,2,1,2,0,2,0,1,0,2,3,2
Maryland,13,Andrew Terrell,5,8,0,1,0,0,0,,0,1,0,0,0,,0,0,0,2,0,0,0,1,0
Minnesota,1,Nate Mason,34,1174,169,450,0.376,115,300,0.383,54,150,0.36,126,156,0.808,22,102,124,169,45,5,65,55,518
Minnesota,2,Amir Coffey,33,1097,131,292,0.449,99,197,0.503,32,95,0.337,110,146,0.753,23,104,127,102,36,5,64,57,404
Minnesota,3,Jordan Murphy,34,934,144,287,0.502,140,255,0.549,4,32,0.125,91,148,0.615,82,218,300,29,23,36,56,102,383
Minnesota,4,Dupree McBrayer,34,947,128,286,0.448,91,197,0.462,37,89,0.416,83,112,0.741,9,59,68,93,29,10,51,51,376
Minnesota,5,Akeem Springs,32,768,102,268,0.381,35,93,0.376,67,175,0.383,32,47,0.681,17,79,96,43,18,6,30,36,303
Minnesota,6,Reggie Lynch,33,763,108,199,0.543,108,199,0.543,0,0,,62,97,0.639,69,132,201,15,15,114,49,112,278
Minnesota,7,Eric Curry,34,681,69,160,0.431,64,131,0.489,5,29,0.172,45,64,0.703,53,124,177,42,15,23,35,69,188
Minnesota,8,Bakary Konate,33,320,19,41,0.463,19,40,0.475,0,1,0,15,24,0.625,29,62,91,3,8,25,18,73,53
Minnesota,9,Ahmad Gilbert,15,75,8,27,0.296,1,5,0.2,7,22,0.318,2,4,0.5,2,12,14,2,2,2,8,7,25
Minnesota,10,Michael Hurt,25,149,6,20,0.3,4,6,0.667,2,14,0.143,4,4,1,4,9,13,6,2,1,6,12,18
Minnesota,11,Brady Rudrud,5,9,2,3,0.667,1,2,0.5,1,1,1,1,2,0.5,0,1,1,0,0,0,0,0,6
Minnesota,12,Gaston Diedhiou,4,9,1,3,0.333,1,2,0.5,0,1,0,0,0,,1,1,2,0,0,0,0,0,2
Minnesota,13,Stephon Sharp,9,16,0,0,,0,0,,0,0,,2,2,1,0,0,0,1,1,0,1,3,2
Minnesota,14,Darin Haugh,5,8,0,1,0,0,0,,0,1,0,0,0,,0,2,2,2,0,0,1,0,0
Michigan,1,Derrick Walton,38,1323,171,392,0.436,73,160,0.456,98,232,0.422,149,170,0.876,17,165,182,188,43,1,66,66,589
Michigan,2,Zak Irvin,38,1345,195,430,0.453,141,273,0.516,54,157,0.344,51,76,0.671,23,149,172,113,34,2,71,45,495
Michigan,3,Moritz Wagner,38,908,168,300,0.56,123,186,0.661,45,114,0.395,77,106,0.726,51,107,158,20,39,14,54,102,458
Michigan,4,D.J. Wilson,38,1155,164,305,0.538,123,195,0.631,41,110,0.373,50,60,0.833,57,146,203,50,20,57,42,73,419
Michigan,5,Muhammad-Ali Abdur-Rahkman,38,1164,120,259,0.463,78,148,0.527,42,111,0.378,62,81,0.765,27,78,105,74,35,4,40,82,344
Michigan,6,Duncan Robinson,38,764,101,215,0.47,37,64,0.578,64,151,0.424,25,32,0.781,11,55,66,33,14,9,19,70,291
Michigan,7,Mark Donnal,38,464,50,81,0.617,41,63,0.651,9,18,0.5,39,50,0.78,35,41,76,4,10,12,15,56,148
Michigan,8,Xavier Simpson,38,332,16,43,0.372,11,24,0.458,5,19,0.263,22,31,0.71,4,20,24,37,21,2,19,47,59
Michigan,9,Ibi Watson,19,83,10,29,0.345,9,11,0.818,1,18,0.056,3,4,0.75,0,8,8,1,2,0,3,5,24
Michigan,10,Sean Lonergan,17,36,4,9,0.444,4,7,0.571,0,2,0,3,6,0.5,1,6,7,3,0,1,2,11,11
Michigan,11,Jon Teske,20,60,1,7,0.143,1,6,0.167,0,1,0,3,6,0.5,7,5,12,2,2,6,1,10,5
Michigan,12,Fred Wright-Jones,13,19,1,4,0.25,0,2,0,1,2,0.5,2,2,1,0,1,1,0,0,0,1,2,5
Michigan,13,Brent Hibbitts,11,22,1,2,0.5,0,0,,1,2,0.5,0,0,,2,2,4,2,0,0,2,2,3
Northwestern,1,Bryant McIntosh,36,1231,199,493,0.404,157,356,0.441,42,137,0.307,94,108,0.87,9,91,100,188,26,4,96,74,534
Northwestern,2,Scottie Lindsey,32,975,163,384,0.424,105,204,0.515,58,180,0.322,67,80,0.838,17,105,122,73,32,8,45,73,451
Northwestern,3,Vic Law,36,1155,147,366,0.402,87,216,0.403,60,150,0.4,90,122,0.738,46,163,209,63,37,18,56,96,444
Northwestern,4,Dererk Pardon,28,862,102,167,0.611,102,167,0.611,0,0,,37,68,0.544,92,134,226,32,23,51,30,75,241
Northwestern,5,Isiah Brown,35,519,70,211,0.332,51,145,0.352,19,66,0.288,63,82,0.768,10,32,42,41,19,7,39,58,222
Northwestern,6,Sanjay Lumpkin,36,1007,77,138,0.558,62,88,0.705,15,50,0.3,47,69,0.681,52,144,196,49,22,15,25,113,216
Northwestern,7,Gavin Skelly,36,637,72,155,0.465,54,95,0.568,18,60,0.3,52,69,0.754,51,81,132,46,12,44,47,100,214
Northwestern,8,Nathan Taphorn,35,427,52,110,0.473,13,27,0.481,39,83,0.47,13,16,0.813,11,40,51,23,5,7,15,41,156
Northwestern,9,Barret Benson,32,255,26,44,0.591,26,44,0.591,0,0,,13,23,0.565,21,30,51,12,9,19,11,50,65
Northwestern,10,Jordan Ash,26,104,5,21,0.238,0,5,0,5,16,0.313,0,0,,1,11,12,10,5,1,5,10,15
Northwestern,11,Aaron Falzon,3,20,0,3,0,0,0,,0,3,0,0,0,,0,2,2,3,0,1,1,1,0
Northwestern,12,Charlie Hall,7,8,0,2,0,0,0,,0,2,0,0,0,,1,3,4,0,0,0,0,0,0
Michigan State,1,Nick Ward,35,694,181,306,0.592,181,306,0.592,0,0,,123,200,0.615,97,130,227,14,12,54,58,98,485
Michigan State,2,Miles Bridges,28,895,177,364,0.486,121,220,0.55,56,144,0.389,63,92,0.685,41,191,232,58,19,43,66,52,473
Michigan State,3,Eron Harris,27,618,101,234,0.432,58,123,0.472,43,111,0.387,45,59,0.763,14,67,81,46,11,5,47,40,290
Michigan State,4,Joshua Langford,35,735,94,189,0.497,57,100,0.57,37,89,0.416,17,26,0.654,25,56,81,38,14,3,38,70,242
Michigan State,5,Cassius Winston,35,724,77,182,0.423,50,111,0.45,27,71,0.38,55,70,0.786,6,58,64,182,26,5,77,72,236
Michigan State,6,Alvin Ellis,35,678,72,180,0.4,31,67,0.463,41,113,0.363,40,57,0.702,22,86,108,43,22,13,49,67,225
Michigan State,7,Matt McQuaid,34,714,61,173,0.353,19,53,0.358,42,120,0.35,25,35,0.714,19,45,64,41,14,2,27,67,189
Michigan State,8,Lourawls Nairn,35,799,48,115,0.417,36,78,0.462,12,37,0.324,14,27,0.519,3,84,87,127,15,4,39,59,122
Michigan State,9,Kenny Goins,35,639,48,83,0.578,48,83,0.578,0,0,,22,33,0.667,38,121,159,21,8,21,37,92,118
Michigan State,10,Kyle Ahrens,34,278,30,70,0.429,15,25,0.6,15,45,0.333,12,16,0.75,6,33,39,8,1,0,9,46,87
Michigan State,11,Matt Van Dyk,30,231,14,26,0.538,14,26,0.538,0,0,,11,23,0.478,27,25,52,12,9,12,12,34,39
Michigan State,12,Conner George,10,12,1,2,0.5,1,1,1,0,1,0,4,6,0.667,0,3,3,1,0,0,3,0,6
Michigan State,13,Greg Roy,8,8,1,3,0.333,1,2,0.5,0,1,0,1,2,0.5,1,0,1,0,0,0,0,2,3
Iowa,1,Peter Jok,32,983,199,466,0.427,115,245,0.469,84,221,0.38,154,169,0.911,31,146,177,84,34,3,81,70,636
Iowa,2,Jordan Bohannon,34,1005,118,304,0.388,29,90,0.322,89,214,0.416,47,55,0.855,9,67,76,175,29,2,76,55,372
Iowa,3,Tyler Cook,27,662,128,231,0.554,126,223,0.565,2,8,0.25,73,122,0.598,53,90,143,26,18,11,65,67,331
Iowa,4,Cordell Pemsl,34,655,116,188,0.617,116,187,0.62,0,1,0,69,120,0.575,61,108,169,37,25,24,53,84,301
Iowa,5,Nicholas Baer,34,808,91,203,0.448,45,87,0.517,46,116,0.397,27,44,0.614,69,127,196,59,48,43,27,78,255
Iowa,6,Isaiah Moss,34,580,84,204,0.412,55,123,0.447,29,81,0.358,23,31,0.742,9,46,55,29,19,13,36,42,220
Iowa,7,Ahmad Wagner,34,545,63,123,0.512,63,121,0.521,0,2,0,38,82,0.463,63,53,116,46,27,14,30,71,164
Iowa,8,Brady Ellingson,34,484,49,111,0.441,17,43,0.395,32,68,0.471,18,18,1,7,32,39,37,11,0,14,28,148
Iowa,9,Dom Uhl,32,467,34,97,0.351,24,55,0.436,10,42,0.238,35,52,0.673,30,72,102,38,5,9,31,31,113
Iowa,10,Ryan Kriener,28,235,38,69,0.551,37,64,0.578,1,5,0.2,9,15,0.6,16,45,61,11,6,9,18,39,86
Iowa,11,Christian Williams,34,435,32,92,0.348,30,79,0.38,2,13,0.154,14,27,0.519,10,44,54,53,26,1,30,29,80
Iowa,12,Maishe Dailey,12,91,10,22,0.455,6,10,0.6,4,12,0.333,3,6,0.5,3,16,19,5,4,1,5,6,27
Iowa,13,Dale Jones,5,16,1,8,0.125,0,1,0,1,7,0.143,0,0,,1,3,4,1,0,0,2,5,3
Iowa,14,Charlie Rose,7,9,1,3,0.333,1,2,0.5,0,1,0,0,0,,0,1,1,1,0,0,1,3,2
Illinois,1,Malcolm Hill,35,1164,189,435,0.434,124,252,0.492,65,183,0.355,160,204,0.784,35,145,180,102,42,13,66,74,603
Illinois,2,Maverick Morgan,35,895,143,265,0.54,143,265,0.54,0,0,,61,93,0.656,61,97,158,30,10,28,59,77,347
Illinois,3,Tracy Abrams,35,846,104,244,0.426,53,117,0.453,51,127,0.402,42,59,0.712,8,93,101,81,36,6,44,70,301
Illinois,4,Jalen Coleman-Lands,35,850,94,257,0.366,23,70,0.329,71,187,0.38,21,25,0.84,7,75,82,34,24,4,35,73,280
Illinois,5,Leron Black,31,627,101,223,0.453,90,186,0.484,11,37,0.297,39,54,0.722,55,141,196,13,14,3,37,89,252
Illinois,6,Michael Finke,32,635,83,172,0.483,46,82,0.561,37,90,0.411,17,31,0.548,49,86,135,21,10,5,30,44,220
Illinois,7,Te'Jon Lucas,31,642,47,115,0.409,35,83,0.422,12,32,0.375,42,71,0.592,7,51,58,95,32,1,51,58,148
Illinois,8,Mike Thorne,24,318,52,95,0.547,52,95,0.547,0,0,,16,35,0.457,28,50,78,8,1,8,27,50,120
Illinois,9,Kipper Nichols,21,286,39,86,0.453,27,59,0.458,12,27,0.444,13,21,0.619,19,41,60,2,7,7,15,47,103
Illinois,10,Jaylon Tate,26,408,18,47,0.383,16,36,0.444,2,11,0.182,24,35,0.686,8,26,34,73,12,2,32,30,62
Illinois,11,D.J. Williams,17,150,17,40,0.425,15,30,0.5,2,10,0.2,3,5,0.6,4,11,15,8,1,5,8,6,39
Illinois,12,Aaron Jordan,24,165,8,28,0.286,2,8,0.25,6,20,0.3,1,6,0.167,6,21,27,5,8,1,4,19,23
Illinois,13,Alex Austin,9,20,2,8,0.25,2,4,0.5,0,4,0,0,0,,4,4,8,0,0,0,0,3,4
Illinois,14,Clayton Jones,9,11,1,3,0.333,0,1,0,1,2,0.5,1,1,1,0,0,0,0,0,0,0,0,4
Illinois,15,Samson Oladimeji,7,8,0,1,0,0,0,,0,1,0,2,3,0.667,2,1,3,0,0,0,0,1,2
Ohio State,1,Jae'Sean Tate,32,1021,182,333,0.547,174,297,0.586,8,36,0.222,86,150,0.573,62,143,205,64,34,15,72,101,458
Ohio State,2,Marc Loving,32,1086,123,295,0.417,65,143,0.455,58,152,0.382,88,119,0.739,33,117,150,60,18,17,89,69,392
Ohio State,3,JaQuan Lyle,31,908,121,264,0.458,88,183,0.481,33,81,0.407,78,108,0.722,10,88,98,142,32,2,75,50,353
Ohio State,4,Trevor Thompson,32,737,125,219,0.571,125,219,0.571,0,0,,90,125,0.72,86,207,293,14,12,48,45,111,340
Ohio State,5,Kam Williams,32,981,108,276,0.391,58,143,0.406,50,133,0.376,34,37,0.919,9,58,67,31,24,4,34,48,300
Ohio State,6,C.J. Jackson,32,611,58,147,0.395,32,66,0.485,26,81,0.321,37,55,0.673,13,66,79,92,27,0,42,52,179
Ohio State,7,Micah Potter,30,422,43,99,0.434,26,48,0.542,17,51,0.333,21,35,0.6,35,57,92,8,8,11,20,68,124
Ohio State,8,Keita Bates-Diop,9,210,37,74,0.5,34,59,0.576,3,15,0.2,10,14,0.714,12,35,47,12,2,12,14,13,87
Ohio State,9,Andre Wesson,29,326,19,52,0.365,6,15,0.4,13,37,0.351,15,28,0.536,15,21,36,9,6,5,18,33,66
Ohio State,10,David Bell,15,101,8,18,0.444,8,18,0.444,0,0,,4,7,0.571,10,19,29,2,2,7,3,17,20
Ohio State,11,Joey Lane,4,12,2,5,0.4,0,1,0,2,4,0.5,1,2,0.5,0,2,2,0,1,0,2,0,7
Ohio State,12,Jimmy Jent,4,10,1,4,0.25,0,2,0,1,2,0.5,0,0,,0,4,4,0,0,0,0,0,3
Indiana,1,James Blackmon,30,915,174,365,0.477,83,150,0.553,91,215,0.423,72,86,0.837,29,115,144,56,21,1,58,54,511
Indiana,2,Robert Johnson,34,999,162,361,0.449,92,172,0.535,70,189,0.37,40,53,0.755,12,137,149,85,29,3,78,73,434
Indiana,3,Thomas Bryant,34,954,148,285,0.519,125,225,0.556,23,60,0.383,108,148,0.73,76,150,226,50,26,52,78,104,427
Indiana,4,Josh Newkirk,34,955,114,260,0.438,79,168,0.47,35,92,0.38,44,63,0.698,23,82,105,107,19,7,76,99,307
Indiana,5,Juwan Morgan,32,722,86,157,0.548,76,117,0.65,10,40,0.25,65,88,0.739,65,113,178,34,19,29,36,84,247
Indiana,6,De'Ron Davis,34,471,66,136,0.485,66,136,0.485,0,0,,68,90,0.756,53,53,106,31,14,24,41,82,200
Indiana,7,OG Anunoby,16,402,68,122,0.557,54,77,0.701,14,45,0.311,27,48,0.563,28,59,87,23,21,21,26,33,177
Indiana,8,Devonte Green,32,485,47,106,0.443,23,51,0.451,24,55,0.436,24,34,0.706,9,48,57,34,22,6,40,24,142
Indiana,9,Curtis Jones,33,370,38,108,0.352,17,48,0.354,21,60,0.35,18,25,0.72,8,36,44,31,14,3,24,28,115
Indiana,10,Freddie McSwain,31,251,32,58,0.552,32,55,0.582,0,3,0,20,32,0.625,35,42,77,4,10,3,23,41,84
Indiana,11,Zach McRoberts,31,350,9,27,0.333,5,15,0.333,4,12,0.333,2,2,1,13,32,45,29,12,6,8,45,24
Indiana,12,Grant Gelon,12,39,7,9,0.778,4,4,1,3,5,0.6,5,8,0.625,2,3,5,0,1,0,1,6,22
Indiana,13,Tim Priller,10,27,7,9,0.778,7,9,0.778,0,0,,5,6,0.833,4,7,11,4,0,2,1,7,19
Indiana,14,Quentin Taylor,6,10,1,1,1,1,1,1,0,0,,0,0,,1,1,2,0,1,0,4,2,2
Penn State,1,Tony Carr,33,1084,141,374,0.377,108,271,0.399,33,103,0.32,121,157,0.771,22,137,159,137,22,10,86,72,436
Penn State,2,Lamar Stevens,33,918,148,344,0.43,137,310,0.442,11,34,0.324,112,146,0.767,54,130,184,55,26,22,72,90,419
Penn State,3,Shep Garner,33,1058,133,350,0.38,51,121,0.421,82,229,0.358,48,63,0.762,13,81,94,78,40,3,61,62,396
Penn State,4,Payton Banks,32,853,106,293,0.362,33,92,0.359,73,201,0.363,49,60,0.817,12,59,71,31,14,9,31,64,334
Penn State,5,Mike Watkins,33,786,128,218,0.587,128,218,0.587,0,0,,63,98,0.643,81,182,263,20,26,89,44,83,319
Penn State,6,Josh Reaves,28,759,81,181,0.448,62,122,0.508,19,59,0.322,34,48,0.708,37,75,112,59,60,21,54,84,215
Penn State,7,Terrence Samuel,28,468,35,86,0.407,29,68,0.426,6,18,0.333,32,44,0.727,11,53,64,49,18,1,23,32,108
Penn State,8,Julian Moore,32,476,35,76,0.461,35,76,0.461,0,0,,19,27,0.704,38,56,94,11,8,24,28,63,89
Penn State,9,Nazeer Bostick,18,120,9,29,0.31,9,21,0.429,0,8,0,5,5,1,2,12,14,6,7,4,9,13,23
Penn State,10,Deividas Zemgulis,18,111,5,20,0.25,2,6,0.333,3,14,0.214,1,2,0.5,3,9,12,1,2,1,7,21,14
Penn State,11,Isaiah Washington,17,85,3,14,0.214,0,2,0,3,12,0.25,3,4,0.75,0,5,5,2,1,0,5,12,12
Penn State,12,Grant Hazle,4,2,1,2,0.5,1,2,0.5,0,0,,0,0,,0,0,0,0,0,0,0,0,2
Penn State,13,Alex Zhao,4,5,0,2,0,0,1,0,0,1,0,0,0,,1,0,1,0,0,0,0,0,0
Nebraska,1,Tai Webster,31,1075,183,434,0.422,143,299,0.478,40,135,0.296,122,164,0.744,33,125,158,124,42,4,100,74,528
Nebraska,2,Glynn Watson Jr.,31,979,144,346,0.416,96,224,0.429,48,122,0.393,68,84,0.81,16,77,93,81,50,4,48,91,404
Nebraska,3,Jack McVeigh,30,688,73,196,0.372,26,57,0.456,47,139,0.338,32,41,0.78,14,62,76,19,16,8,21,27,225
Nebraska,4,Ed Morrow,24,562,92,179,0.514,92,179,0.514,0,0,,41,67,0.612,77,103,180,8,8,27,47,67,225
Nebraska,5,Michael Jacobson,31,743,72,184,0.391,68,161,0.422,4,23,0.174,37,57,0.649,89,103,192,33,23,27,28,77,185
Nebraska,6,Evan Taylor,31,755,64,155,0.413,58,130,0.446,6,25,0.24,27,37,0.73,17,72,89,37,28,3,37,54,161
Nebraska,7,Jordy Tshimanga,31,389,57,127,0.449,57,127,0.449,0,0,,40,64,0.625,54,69,123,8,14,15,46,69,154
Nebraska,8,Jeriah Horne,29,341,47,116,0.405,25,50,0.5,22,66,0.333,10,15,0.667,9,46,55,11,7,3,23,27,126
Nebraska,9,Isaiah Roby,30,457,37,94,0.394,33,74,0.446,4,20,0.2,16,21,0.762,36,52,88,22,16,25,36,58,94
Nebraska,10,Anton Gill,12,208,16,59,0.271,8,30,0.267,8,29,0.276,5,8,0.625,7,16,23,6,4,0,11,17,45
Nebraska,11,Nick Fuller,15,85,6,9,0.667,6,9,0.667,0,0,,5,7,0.714,5,12,17,4,2,0,1,15,17
Nebraska,12,Mohammad Elradi,2,3,1,1,1,1,1,1,0,0,,0,0,,0,1,1,1,0,0,0,0,2
Nebraska,13,Malcolm Laws,5,11,1,6,0.167,1,5,0.2,0,1,0,0,3,0,0,1,1,0,1,0,0,0,2
Nebraska,14,Tanner Borchardt,1,1,0,0,,0,0,,0,0,,0,0,,0,0,0,0,0,0,0,1,0
Nebraska,15,Jason Shultis,2,3,0,0,,0,0,,0,0,,0,0,,1,2,3,0,0,0,0,0,0
Rutgers,1,Corey Sanders,33,1003,163,427,0.382,142,348,0.408,21,79,0.266,76,124,0.613,17,90,107,107,44,16,90,63,423
Rutgers,2,DeShawn Freeman,33,890,137,284,0.482,131,268,0.489,6,16,0.375,85,137,0.62,94,163,257,29,32,30,64,87,365
Rutgers,3,Nigel Johnson,32,838,125,332,0.377,82,209,0.392,43,123,0.35,70,100,0.7,13,92,105,64,37,2,45,29,363
Rutgers,4,Mike Williams,33,865,109,278,0.392,66,143,0.462,43,135,0.319,49,67,0.731,70,98,168,37,30,9,33,76,310
Rutgers,5,C.J. Gettys,33,725,106,195,0.544,106,195,0.544,0,0,,42,63,0.667,66,107,173,38,13,26,52,80,254
Rutgers,6,Issa Thiam,31,570,42,127,0.331,12,29,0.414,30,98,0.306,4,8,0.5,11,43,54,10,12,2,24,33,118
Rutgers,7,Candido Sa,32,431,38,96,0.396,34,77,0.442,4,19,0.211,21,46,0.457,42,47,89,9,9,29,26,56,101
Rutgers,8,Jonathan Laurent,31,413,34,80,0.425,30,65,0.462,4,15,0.267,20,28,0.714,18,57,75,12,15,5,32,41,92
Rutgers,9,Eugene Omoruyi,33,395,29,82,0.354,29,71,0.408,0,11,0,20,32,0.625,32,41,73,34,15,9,35,47,78
Rutgers,10,Shaquille Doorson,31,272,18,32,0.563,18,32,0.563,0,0,,3,15,0.2,28,23,51,8,3,14,12,39,39
Rutgers,11,Ibrahima Diallo,18,150,6,27,0.222,6,26,0.231,0,1,0,3,8,0.375,13,19,32,5,5,11,9,30,15
Rutgers,12,Khalil Batie,7,14,1,3,0.333,0,0,,1,3,0.333,0,1,0,0,3,3,2,0,0,1,1,3
Rutgers,13,Jake Dadika,10,52,1,3,0.333,1,2,0.5,0,1,0,0,0,,0,2,2,5,2,0,4,1,2
Rutgers,14,Matt Bullock,2,4,0,1,0,0,0,,0,1,0,0,0,,0,0,0,0,0,0,0,1,0
Rutgers,15,Joey Downes,1,0,0,0,,0,0,,0,0,,0,0,,1,0,1,0,0,0,0,0,0
Rutgers,16,Aaren Smith,1,4,0,0,,0,0,,0,0,,0,2,0,0,0,0,0,0,0,0,0,0